"date","geography","geography code","Rural Urban","Variable: All usual residents; measures: Value","Variable: Males; measures: Value","Variable: Females; measures: Value","Variable: Lives in a household; measures: Value","Variable: Lives in a communal establishment; measures: Value","Variable: Schoolchild or full-time student aged 4 and over at their non term-time address; measures: Value","Variable: Area (Hectares); measures: Value","Variable: Density (number of persons per hectare); measures: Value"
"2011","Kexby BUA","E34000001","Total",340,169,171,340,0,7,20.25,16.8
"2011","Bradfield Heath BUA","E34000002","Total",719,360,359,706,13,6,76.75,9.4
"2011","Huntley BUA","E34000003","Total",1105,528,577,1085,20,12,33.50,33.0
"2011","Swinefleet BUA","E34000004","Total",787,408,379,770,17,12,33.25,23.7
"2011","Foulsham BUA","E34000005","Total",1021,509,512,1008,13,17,41.25,24.8
"2011","Easton (South Norfolk) BUA","E34000006","Total",1514,760,754,1438,76,22,39.25,38.6
"2011","Carlton in Lindrick BUA","E34000007","Total",5456,2602,2854,5421,35,44,198.50,27.5
"2011","Shrewton BUA","E34000008","Total",1723,839,884,1721,2,50,82.00,21.0
"2011","Maiden Newton BUA","E34000009","Total",1268,626,642,1254,14,19,40.50,31.3
"2011","Normanton on Soar BUA","E34000010","Total",448,213,235,448,0,16,25.25,17.7
"2011","Warton BUA","E34000011","Total",1441,700,741,1364,77,19,35.75,40.3
"2011","Hartland BUA","E34000012","Total",910,443,467,910,0,17,26.75,34.0
"2011","Buntingsdale BUA","E34000013","Total",806,412,394,801,5,12,31.50,25.6
"2011","Nonington BUA","E34000014","Total",339,168,171,339,0,4,27.75,12.2
"2011","Madeley Park BUA","E34000015","Total",255,126,129,255,0,4,29.25,8.7
"2011","Dorchester (West Dorset) BUA","E34000016","Total",19060,9215,9845,18489,571,336,492.00,38.7
"2011","Sayers Common BUA","E34000017","Total",869,425,444,869,0,12,26.25,33.1
"2011","Dinghurst BUA","E34000018","Total",309,139,170,291,18,10,36.00,8.6
"2011","Hartnoll BUA","E34000019","Total",264,131,133,264,0,5,30.75,8.6
"2011","Ely BUA","E34000020","Total",19090,9346,9744,18746,344,207,476.75,40.0
"2011","Gilmorton BUA","E34000021","Total",976,497,479,976,0,39,31.75,30.7
"2011","Huttoft BUA","E34000022","Total",585,297,288,562,23,6,27.25,21.5
"2011","West Chinnock BUA","E34000023","Total",592,293,299,592,0,5,29.75,19.9
"2011","Great Tey BUA","E34000024","Total",620,306,314,620,0,11,31.50,19.7
"2011","Little Addington BUA","E34000025","Total",328,167,161,307,21,7,20.75,15.8
"2011","Market Weighton BUA","E34000026","Total",6429,3106,3323,6371,58,75,175.25,36.7
"2011","Downham Market BUA","E34000027","Total",10884,5196,5688,10761,123,111,380.75,28.6
"2011","Kingston St Mary BUA","E34000028","Total",393,178,215,393,0,11,33.50,11.7
"2011","Orlingbury BUA","E34000029","Total",439,221,218,439,0,9,27.00,16.3
"2011","Rode BUA","E34000030","Total",1025,489,536,1025,0,32,50.75,20.2
"2011","Upper Denby BUA","E34000031","Total",715,352,363,715,0,12,26.25,27.2
"2011","Shilton BUA","E34000032","Total",230,120,110,230,0,13,21.25,10.8
"2011","Witcham BUA","E34000033","Total",429,221,208,429,0,12,29.00,14.8
"2011","Read BUA","E34000034","Total",2573,1245,1328,2573,0,58,97.25,26.5
"2011","Salford Priors BUA","E34000035","Total",590,289,301,560,30,12,23.75,24.8
"2011","Hyde Heath BUA","E34000036","Total",1047,509,538,1003,44,24,45.75,22.9
"2011","Padstow BUA","E34000037","Total",2296,1091,1205,2251,45,19,78.25,29.3
"2011","Willoughby (East Lindsey) BUA","E34000038","Total",355,175,180,355,0,4,25.00,14.2
"2011","Penrith BUA","E34000039","Total",15181,7379,7802,14896,285,186,464.75,32.7
"2011","Winterborne Whitechurch BUA","E34000040","Total",757,385,372,757,0,10,27.75,27.3
"2011","Bloxham BUA","E34000041","Total",3374,1686,1688,3164,210,120,117.50,28.7
"2011","Stonebridge BUA","E34000042","Total",249,125,124,249,0,4,25.00,10.0
"2011","Lyng BUA","E34000043","Total",807,406,401,807,0,19,36.75,22.0
"2011","Pawlett BUA","E34000044","Total",892,446,446,892,0,13,33.25,26.8
"2011","Ealand BUA","E34000045","Total",900,458,442,898,2,29,40.00,22.5
"2011","Husthwaite BUA","E34000046","Total",404,196,208,404,0,19,30.25,13.4
"2011","Brough (Eden) BUA","E34000047","Total",751,374,377,750,1,2,32.50,23.1
"2011","Bolsover BUA","E34000048","Total",11754,5721,6033,11651,103,76,356.25,33.0
"2011","Cambridge (Stroud) BUA","E34000049","Total",394,210,184,394,0,5,20.75,19.0
"2011","Witton-le-Wear BUA","E34000050","Total",567,282,285,567,0,11,33.00,17.2
"2011","Moreton on Lugg BUA","E34000051","Total",920,460,460,920,0,15,26.25,35.0
"2011","Buntingford BUA","E34000052","Total",4948,2449,2499,4895,53,80,140.25,35.3
"2011","Low Fulney BUA","E34000053","Total",481,250,231,481,0,7,74.50,6.5
"2011","Felmersham BUA","E34000054","Total",398,195,203,398,0,11,26.00,15.3
"2011","March BUA","E34000055","Total",21051,10184,10867,20796,255,161,635.25,33.1
"2011","Southam BUA","E34000056","Total",6567,3206,3361,6491,76,100,178.00,36.9
"2011","Marston BUA","E34000057","Total",360,177,183,360,0,15,29.25,12.3
"2011","Grimethorpe BUA","E34000058","Total",4672,2298,2374,4569,103,23,128.75,36.3
"2011","Easington (East Riding of Yorkshire) BUA","E34000059","Total",691,333,358,688,3,4,85.50,8.1
"2011","Chudleigh BUA","E34000060","Total",4011,1962,2049,3945,66,73,95.25,42.1
"2011","Slad BUA","E34000061","Total",388,197,191,388,0,11,20.50,18.9
"2011","Catterick BUA","E34000062","Total",3155,1831,1324,2532,623,43,100.50,31.4
"2011","Great Oakley BUA","E34000063","Total",702,355,347,696,6,11,33.00,21.3
"2011","Hemswell BUA","E34000064","Total",391,197,194,391,0,7,26.25,14.9
"2011","Axtown BUA","E34000065","Total",312,144,168,309,3,14,56.50,5.5
"2011","Moor Row BUA","E34000066","Total",787,420,367,787,0,7,21.00,37.5
"2011","Royston BUA","E34000067","Total",15781,7829,7952,15712,69,218,408.50,38.6
"2011","Studley BUA","E34000068","Total",6203,3007,3196,6127,76,69,172.25,36.0
"2011","Wheatley Hill BUA","E34000069","Total",3144,1562,1582,3098,46,17,73.50,42.8
"2011","Fleckney BUA","E34000070","Total",4894,2437,2457,4887,7,72,107.00,45.7
"2011","Tickenham BUA","E34000071","Total",585,294,291,585,0,11,65.00,9.0
"2011","Byers Green BUA","E34000072","Total",858,426,432,856,2,6,22.75,37.7
"2011","Whitwell (Bolsover) BUA","E34000073","Total",3716,1836,1880,3673,43,36,100.75,36.9
"2011","Kingsbury BUA","E34000074","Total",3730,1828,1902,3730,0,37,77.50,48.1
"2011","Hazelbury Bryan BUA","E34000075","Total",445,220,225,445,0,8,33.25,13.4
"2011","Weston (North Hertfordshire) BUA","E34000076","Total",897,429,468,897,0,16,51.00,17.6
"2011","Belbroughton BUA","E34000077","Total",1272,636,636,1250,22,25,41.25,30.8
"2011","North Creake BUA","E34000078","Total",386,191,195,386,0,6,32.00,12.1
"2011","Simister BUA","E34000079","Total",639,315,324,639,0,7,22.50,28.4
"2011","Tempsford BUA","E34000080","Total",590,291,299,590,0,5,26.25,22.5
"2011","Ludgershall (Wiltshire) BUA","E34000081","Total",4427,2132,2295,4381,46,34,125.00,35.4
"2011","Droxford BUA","E34000082","Total",675,325,350,656,19,23,35.75,18.9
"2011","Willingham by Stow BUA","E34000083","Total",488,237,251,488,0,12,29.00,16.8
"2011","Barnoldby le Beck BUA","E34000084","Total",346,168,178,346,0,15,26.25,13.2
"2011","West Ashling BUA","E34000085","Total",341,166,175,341,0,4,20.25,16.8
"2011","Irthlingborough BUA","E34000086","Total",7502,3733,3769,7409,93,66,184.25,40.7
"2011","Galhampton BUA","E34000087","Total",312,154,158,312,0,5,20.75,15.0
"2011","Manea BUA","E34000088","Total",2088,1009,1079,2088,0,20,104.00,20.1
"2011","West Hanningfield BUA","E34000089","Total",348,171,177,348,0,8,30.50,11.4
"2011","Halberton BUA","E34000090","Total",865,422,443,862,3,14,49.00,17.7
"2011","Runcton Holme BUA","E34000091","Total",657,329,328,657,0,16,27.00,24.3
"2011","Ryhall BUA","E34000092","Total",1459,712,747,1459,0,26,63.75,22.9
"2011","Cuxton BUA","E34000093","Total",4438,2188,2250,4436,2,48,155.75,28.5
"2011","Twyford (Melton) BUA","E34000094","Total",318,172,146,318,0,5,23.50,13.5
"2011","Hartest BUA","E34000095","Total",446,220,226,446,0,11,21.00,21.2
"2011","Stoke Goldington BUA","E34000096","Total",575,285,290,575,0,15,26.00,22.1
"2011","Wateringbury BUA","E34000097","Total",2396,1160,1236,2354,42,46,67.25,35.6
"2011","Over Kellet BUA","E34000098","Total",581,277,304,581,0,6,31.50,18.4
"2011","Little Wymondley BUA","E34000099","Total",995,465,530,935,60,11,33.75,29.5
"2011","Moira BUA","E34000100","Total",2458,1180,1278,2438,20,30,93.75,26.2
"2011","Drayton (South Somerset) BUA","E34000101","Total",379,183,196,377,2,9,30.25,12.5
"2011","Mellis BUA","E34000102","Total",519,250,269,490,29,13,37.25,13.9
"2011","Market Bosworth BUA","E34000103","Total",2097,1002,1095,2036,61,54,72.25,29.0
"2011","Ashill BUA","E34000104","Total",1172,571,601,1172,0,5,47.25,24.8
"2011","Rode Heath BUA","E34000105","Total",2019,1013,1006,2019,0,25,45.50,44.4
"2011","Thurton BUA","E34000106","Total",883,425,458,883,0,23,34.75,25.4
"2011","Hail Weston BUA","E34000107","Total",610,310,300,610,0,12,24.25,25.2
"2011","Twigworth BUA","E34000108","Total",728,368,360,710,18,12,32.25,22.6
"2011","Freshwater BUA","E34000109","Total",7829,3704,4125,7592,237,78,363.00,21.6
"2011","Hardwick (South Norfolk) BUA","E34000110","Total",298,147,151,298,0,8,22.00,13.5
"2011","Waresley BUA","E34000111","Total",279,138,141,279,0,0,32.75,8.5
"2011","Gweek BUA","E34000112","Total",667,351,316,667,0,3,24.50,27.2
"2011","Crick BUA","E34000113","Total",1886,959,927,1877,9,48,97.50,19.3
"2011","Wrestlingworth BUA","E34000114","Total",591,274,317,591,0,11,30.75,19.2
"2011","Barnoldswick BUA","E34000115","Total",10435,5153,5282,10354,81,98,234.00,44.6
"2011","Rackheath Industrial Estate BUA","E34000116","Total",344,154,190,344,0,4,27.50,12.5
"2011","Lutton BUA","E34000117","Total",779,392,387,779,0,5,25.50,30.5
"2011","Seahouses BUA","E34000118","Total",1959,953,1006,1952,7,16,97.25,20.1
"2011","Billinghay BUA","E34000119","Total",2046,978,1068,2006,40,19,82.75,24.7
"2011","Hollinfare BUA","E34000120","Total",913,448,465,913,0,4,22.25,41.0
"2011","Potterhanworth BUA","E34000121","Total",839,394,445,839,0,19,33.50,25.0
"2011","Wheathampstead BUA","E34000122","Total",4326,2044,2282,4321,5,91,115.25,37.5
"2011","Winfarthing BUA","E34000123","Total",503,244,259,503,0,10,23.00,21.9
"2011","Aberford BUA","E34000124","Total",1503,735,768,1503,0,23,58.75,25.6
"2011","Northiam BUA","E34000125","Total",1785,864,921,1734,51,35,96.00,18.6
"2011","Hawkesbury Upton BUA","E34000126","Total",991,468,523,963,28,34,35.00,28.3
"2011","Wedmore BUA","E34000127","Total",1409,670,739,1409,0,37,75.50,18.7
"2011","High Bickington BUA","E34000128","Total",837,419,418,837,0,14,23.75,35.2
"2011","Carlton-on-Trent BUA","E34000129","Total",229,108,121,229,0,7,20.50,11.2
"2011","Ropley BUA","E34000130","Total",477,219,258,477,0,17,34.50,13.8
"2011","University of Sussex BUA","E34000131","Total",2681,1252,1429,388,2293,72,44.75,59.9
"2011","Wetheringsett BUA","E34000132","Total",334,179,155,334,0,11,20.25,16.5
"2011","Burchett's Green BUA","E34000133","Total",306,153,153,303,3,10,22.75,13.5
"2011","Stevington BUA","E34000134","Total",552,267,285,552,0,9,32.25,17.1
"2011","Grange-over-Sands BUA","E34000135","Total",4788,2232,2556,4668,120,75,199.75,24.0
"2011","Riding Mill BUA","E34000136","Total",966,448,518,925,41,25,64.25,15.0
"2011","Ashton under Hill BUA","E34000137","Total",753,365,388,753,0,17,44.75,16.8
"2011","Osmotherley BUA","E34000138","Total",668,336,332,665,3,16,27.25,24.5
"2011","Friskney Eaudyke BUA","E34000139","Total",645,325,320,645,0,3,35.50,18.2
"2011","Cranborne BUA","E34000140","Total",606,283,323,590,16,12,27.75,21.8
"2011","Preston (North Hertfordshire) BUA","E34000141","Total",420,195,225,393,27,17,26.50,15.8
"2011","Theale BUA","E34000142","Total",377,182,195,377,0,10,23.75,15.9
"2011","Old Stratford BUA","E34000143","Total",1996,1018,978,1996,0,28,48.00,41.6
"2011","Cublington BUA","E34000144","Total",328,156,172,328,0,7,22.25,14.7
"2011","Rudston BUA","E34000145","Total",409,192,217,409,0,2,31.75,12.9
"2011","Bury BUA","E34000146","Total",400,199,201,380,20,11,42.75,9.4
"2011","Cropredy BUA","E34000147","Total",717,359,358,717,0,16,30.00,23.9
"2011","Aldbourne BUA","E34000148","Total",1652,821,831,1632,20,42,77.50,21.3
"2011","Shipham BUA","E34000149","Total",1087,540,547,1068,19,23,47.50,22.9
"2011","Middleton Cheney BUA","E34000150","Total",3597,1737,1860,3567,30,57,98.75,36.4
"2011","Tarporley BUA","E34000151","Total",2614,1268,1346,2605,9,71,98.25,26.6
"2011","Cleeve BUA","E34000152","Total",721,363,358,721,0,7,38.00,19.0
"2011","Alderton (Suffolk Coastal) BUA","E34000153","Total",423,200,223,421,2,5,22.00,19.2
"2011","Batcombe BUA","E34000154","Total",439,224,215,439,0,16,25.75,17.0
"2011","Moreton BUA","E34000155","Total",294,139,155,294,0,9,23.50,12.5
"2011","Wirksworth BUA","E34000156","Total",5038,2516,2522,5021,17,81,161.00,31.3
"2011","St Mawes BUA","E34000157","Total",714,339,375,714,0,6,65.00,11.0
"2011","Stratton Audley BUA","E34000158","Total",434,215,219,434,0,16,28.00,15.5
"2011","Saxton BUA","E34000159","Total",592,288,304,561,31,14,23.50,25.2
"2011","Woodcote BUA","E34000160","Total",2604,1389,1215,2382,222,93,115.50,22.5
"2011","Dalton-in-Furness BUA","E34000161","Total",7827,3863,3964,7782,45,91,160.50,48.8
"2011","Blyth (Bassetlaw) BUA","E34000162","Total",968,484,484,946,22,13,47.50,20.4
"2011","Haughley BUA","E34000163","Total",1285,620,665,1285,0,20,36.50,35.2
"2011","Howe Green BUA","E34000164","Total",666,313,353,627,39,16,42.75,15.6
"2011","Calstock BUA","E34000165","Total",790,378,412,790,0,21,47.50,16.6
"2011","Five Oak Green BUA","E34000166","Total",1540,765,775,1507,33,21,42.75,36.0
"2011","Leasingham BUA","E34000167","Total",1584,750,834,1554,30,20,58.25,27.2
"2011","Southrop BUA","E34000168","Total",245,128,117,245,0,9,22.25,11.0
"2011","Wells-next-the-Sea BUA","E34000169","Total",2165,1029,1136,2123,42,22,97.75,22.1
"2011","Tredington BUA","E34000170","Total",474,209,265,474,0,2,27.75,17.1
"2011","Landrake BUA","E34000171","Total",1115,566,549,1115,0,8,24.75,45.1
"2011","Campsall BUA","E34000172","Total",1940,927,1013,1940,0,17,48.75,39.8
"2011","Welney BUA","E34000173","Total",542,281,261,524,18,8,24.00,22.6
"2011","Bedlington BUA","E34000174","Total",16974,8207,8767,16793,181,120,380.00,44.7
"2011","Brigg BUA","E34000175","Total",6787,3341,3446,6655,132,73,267.75,25.3
"2011","Steeple Aston BUA","E34000176","Total",947,470,477,939,8,24,57.50,16.5
"2011","Great Barford BUA","E34000177","Total",2003,969,1034,2003,0,25,73.50,27.3
"2011","Acton Turville BUA","E34000178","Total",370,186,184,370,0,7,26.75,13.8
"2011","Abbotsbury BUA","E34000179","Total",481,238,243,481,0,8,24.50,19.6
"2011","Clive BUA","E34000180","Total",530,266,264,530,0,10,29.25,18.1
"2011","Widnes BUA","E34000181","Total",61464,29935,31529,60961,503,511,1881.50,32.7
"2011","Hethersett BUA","E34000182","Total",5520,2631,2889,5436,84,94,170.75,32.3
"2011","Pevensey Bay BUA","E34000183","Total",2864,1353,1511,2850,14,16,102.25,28.0
"2011","Coningsby Airfield BUA","E34000184","Total",5021,2662,2359,4457,564,55,366.75,13.7
"2011","Williton BUA","E34000185","Total",2644,1238,1406,2566,78,42,112.00,23.6
"2011","Salthouse BUA","E34000186","Total",201,105,96,201,0,6,22.75,8.8
"2011","Cople BUA","E34000187","Total",722,359,363,722,0,15,39.25,18.4
"2011","Amble BUA","E34000188","Total",6025,2938,3087,5979,46,52,149.00,40.4
"2011","Cholsey BUA","E34000189","Total",3081,1530,1551,3071,10,58,95.75,32.2
"2011","Terwick Common BUA","E34000190","Total",354,179,175,354,0,18,23.25,15.2
"2011","Overton (Lancaster) BUA","E34000191","Total",1069,533,536,1068,1,13,42.75,25.0
"2011","Little Plumstead BUA","E34000192","Total",656,318,338,645,11,0,22.25,29.5
"2011","Skelton (Redcar and Cleveland) BUA","E34000193","Total",6535,3182,3353,6523,12,65,161.75,40.4
"2011","Chillington BUA","E34000194","Total",877,418,459,877,0,14,35.75,24.5
"2011","Steeple Morden BUA","E34000195","Total",852,417,435,852,0,15,46.25,18.4
"2011","Ellingham BUA","E34000196","Total",679,338,341,679,0,7,39.25,17.3
"2011","Honington BUA","E34000197","Total",323,158,165,323,0,5,21.25,15.2
"2011","Holberrow Green BUA","E34000198","Total",443,218,225,443,0,18,21.25,20.8
"2011","Saxby All Saints BUA","E34000199","Total",385,184,201,385,0,11,23.25,16.6
"2011","Wawne BUA","E34000200","Total",975,481,494,969,6,1,32.00,30.5
"2011","Barlborough BUA","E34000201","Total",2975,1482,1493,2975,0,37,121.75,24.4
"2011","Hamsterley (nr Witton-le-Wear) BUA","E34000202","Total",445,240,205,445,0,4,26.50,16.8
"2011","Marton (Rugby) BUA","E34000203","Total",484,227,257,484,0,11,22.75,21.3
"2011","Snailbeach BUA","E34000204","Total",328,165,163,325,3,7,20.50,16.0
"2011","Bigbury-on-Sea BUA","E34000205","Total",220,113,107,203,17,3,21.50,10.2
"2011","West Tanfield BUA","E34000206","Total",293,154,139,293,0,3,21.00,14.0
"2011","Newquay Cornwall Airport BUA","E34000207","Total",251,117,134,237,14,6,434.50,0.6
"2011","East Budleigh BUA","E34000208","Total",650,301,349,650,0,8,36.25,17.9
"2011","Woodton BUA","E34000209","Total",703,343,360,703,0,10,27.00,26.0
"2011","East Garston BUA","E34000210","Total",535,257,278,535,0,13,31.75,16.9
"2011","Bielby BUA","E34000211","Total",258,126,132,247,11,8,20.50,12.6
"2011","Abbots Bromley BUA","E34000212","Total",1351,631,720,1286,65,44,60.50,22.3
"2011","St Nicholas at Wade BUA","E34000213","Total",705,343,362,705,0,14,27.00,26.1
"2011","New Addington BUA","E34000214","Total",22280,10258,12022,22220,60,165,313.00,71.2
"2011","Iwerne Courtney BUA","E34000215","Total",232,114,118,232,0,6,28.50,8.1
"2011","Three Oaks BUA","E34000216","Total",477,231,246,477,0,4,30.25,15.8
"2011","Shillington BUA","E34000217","Total",1447,723,724,1447,0,19,53.25,27.2
"2011","Bishop's Nympton BUA","E34000218","Total",325,151,174,325,0,7,21.25,15.3
"2011","Urchfont BUA","E34000219","Total",885,407,478,885,0,16,56.75,15.6
"2011","Chippenham (East Cambridgeshire) BUA","E34000220","Total",517,245,272,517,0,10,24.25,21.3
"2011","Heddington BUA","E34000221","Total",456,216,240,446,10,6,21.25,21.5
"2011","Tillingham BUA","E34000222","Total",902,448,454,886,16,6,39.00,23.1
"2011","Sicklesmere BUA","E34000223","Total",849,413,436,849,0,10,28.75,29.5
"2011","Cross BUA","E34000224","Total",337,168,169,337,0,5,29.50,11.4
"2011","Great Bardfield BUA","E34000225","Total",1227,591,636,1227,0,35,52.50,23.4
"2011","Gunthorpe BUA","E34000226","Total",589,296,293,589,0,8,24.00,24.5
"2011","Maulden BUA","E34000227","Total",2357,1145,1212,2357,0,55,84.50,27.9
"2011","Wicken (East Cambridgeshire) BUA","E34000228","Total",698,367,331,698,0,8,48.00,14.5
"2011","Rushton BUA","E34000229","Total",461,232,229,455,6,7,24.75,18.6
"2011","Malpas BUA","E34000230","Total",1321,598,723,1263,58,27,47.00,28.1
"2011","Seaford BUA","E34000231","Total",22584,10786,11798,22120,464,216,632.75,35.7
"2011","Saltfleetby St Peter BUA","E34000232","Total",275,142,133,275,0,4,21.75,12.6
"2011","Broughton Gifford BUA","E34000233","Total",851,418,433,829,22,13,39.75,21.4
"2011","Ryhill BUA","E34000234","Total",5150,2528,2622,5123,27,31,123.25,41.8
"2011","Fordham (Colchester) BUA","E34000235","Total",835,429,406,818,17,10,30.50,27.4
"2011","Whitwell (North Hertfordshire) BUA","E34000236","Total",965,480,485,965,0,24,38.25,25.2
"2011","Skinningrove BUA","E34000237","Total",1606,831,775,1606,0,2,74.00,21.7
"2011","North Luffenham BUA","E34000238","Total",679,329,350,679,0,22,32.75,20.7
"2011","Instow BUA","E34000239","Total",706,338,368,681,25,11,43.75,16.1
"2011","Watchet BUA","E34000240","Total",3581,1747,1834,3581,0,34,102.00,35.1
"2011","Robertsbridge BUA","E34000241","Total",2047,1009,1038,1745,302,55,79.25,25.8
"2011","Budleigh Salterton BUA","E34000242","Total",5185,2353,2832,5062,123,62,228.25,22.7
"2011","Market Weston BUA","E34000243","Total",245,134,111,245,0,7,25.25,9.7
"2011","Brancaster Staithe BUA","E34000244","Total",367,179,188,366,1,9,52.75,7.0
"2011","Sedgebrook BUA","E34000245","Total",355,177,178,355,0,11,22.00,16.1
"2011","Densole BUA","E34000246","Total",937,451,486,934,3,9,51.75,18.1
"2011","Cherry Burton BUA","E34000247","Total",1392,668,724,1364,28,48,47.50,29.3
"2011","Pulloxhill BUA","E34000248","Total",569,284,285,569,0,10,32.00,17.8
"2011","Burton on the Wolds BUA","E34000249","Total",1218,619,599,1218,0,26,43.00,28.3
"2011","Great Dunmow BUA","E34000250","Total",7749,3703,4046,7636,113,114,201.25,38.5
"2011","Aspatria BUA","E34000251","Total",2454,1205,1249,2439,15,13,94.50,26.0
"2011","Old Wives Lees BUA","E34000252","Total",662,328,334,662,0,13,40.50,16.3
"2011","Middleton Tyas BUA","E34000253","Total",581,284,297,580,1,15,35.75,16.3
"2011","Edington BUA","E34000254","Total",734,356,378,734,0,23,46.75,15.7
"2011","Northmoor Green BUA","E34000255","Total",266,138,128,266,0,8,20.50,13.0
"2011","Nunney BUA","E34000256","Total",844,390,454,820,24,4,38.75,21.8
"2011","Rillington BUA","E34000257","Total",1114,563,551,1114,0,9,46.50,24.0
"2011","Ingrave BUA","E34000258","Total",1846,890,956,1814,32,40,70.00,26.4
"2011","Punnett's Town BUA","E34000259","Total",632,311,321,632,0,7,40.25,15.7
"2011","Healing BUA","E34000260","Total",2940,1456,1484,2936,4,55,102.25,28.8
"2011","Shipton Bellinger BUA","E34000261","Total",1504,727,777,1503,1,31,43.00,35.0
"2011","Weedon Lois BUA","E34000262","Total",360,186,174,347,13,16,21.00,17.1
"2011","Wingham BUA","E34000263","Total",1303,628,675,1272,31,22,47.00,27.7
"2011","Brooke BUA","E34000264","Total",1215,568,647,1184,31,17,74.50,16.3
"2011","Weobley BUA","E34000265","Total",1101,509,592,1101,0,13,42.00,26.2
"2011","Stoke Canon BUA","E34000266","Total",654,310,344,654,0,10,22.00,29.7
"2011","Higher Wincham BUA","E34000267","Total",2654,1341,1313,2651,3,52,68.50,38.7
"2011","Keyingham BUA","E34000268","Total",2314,1154,1160,2314,0,28,102.25,22.6
"2011","Dearham BUA","E34000269","Total",1799,899,900,1799,0,23,59.25,30.4
"2011","Tresillian BUA","E34000270","Total",624,300,324,624,0,13,36.75,17.0
"2011","Wideopen BUA","E34000271","Total",8976,4228,4748,8909,67,78,213.00,42.1
"2011","Appleshaw BUA","E34000272","Total",503,247,256,503,0,11,29.50,17.1
"2011","Frodsham BUA","E34000273","Total",9032,4304,4728,8912,120,157,287.00,31.5
"2011","North Pickenham BUA","E34000274","Total",472,232,240,472,0,7,22.00,21.5
"2011","Tilston BUA","E34000275","Total",603,310,293,603,0,20,25.25,23.9
"2011","Postwick BUA","E34000276","Total",404,207,197,391,13,7,21.75,18.6
"2011","Stagsden BUA","E34000277","Total",363,178,185,363,0,9,23.00,15.8
"2011","Rothwell BUA","E34000278","Total",7694,3752,3942,7688,6,83,155.00,49.6
"2011","Chew Magna BUA","E34000279","Total",1149,562,587,1149,0,30,72.50,15.8
"2011","Mursley BUA","E34000280","Total",611,314,297,611,0,12,32.25,18.9
"2011","Sandhurst (Tunbridge Wells) BUA","E34000281","Total",683,329,354,683,0,13,40.50,16.9
"2011","Chacombe BUA","E34000282","Total",659,310,349,610,49,16,22.50,29.3
"2011","Leigh (Sevenoaks) BUA","E34000283","Total",1257,604,653,1257,0,42,65.00,19.3
"2011","Shipdham BUA","E34000284","Total",1860,872,988,1830,30,22,91.25,20.4
"2011","East Ayton BUA","E34000285","Total",2559,1205,1354,2559,0,39,105.75,24.2
"2011","Orsett BUA","E34000286","Total",1267,628,639,1267,0,16,46.00,27.5
"2011","Balsham BUA","E34000287","Total",1591,779,812,1591,0,39,65.25,24.4
"2011","Port Gaverne BUA","E34000288","Total",646,304,342,595,51,2,32.25,20.0
"2011","Ponsanooth BUA","E34000289","Total",967,458,509,950,17,13,41.75,23.2
"2011","Chard BUA","E34000290","Total",13074,6459,6615,12933,141,119,370.00,35.3
"2011","Offord D'Arcy BUA","E34000291","Total",1341,664,677,1341,0,33,61.75,21.7
"2011","Greatham (Hartlepool) BUA","E34000292","Total",939,436,503,903,36,12,28.75,32.7
"2011","Dorney BUA","E34000293","Total",278,138,140,278,0,13,21.25,13.1
"2011","Silkstone BUA","E34000294","Total",1764,858,906,1764,0,32,51.25,34.4
"2011","Wrington BUA","E34000295","Total",1918,907,1011,1918,0,37,74.25,25.8
"2011","Comberbach BUA","E34000296","Total",954,471,483,954,0,23,41.00,23.3
"2011","Gilsland BUA","E34000297","Total",205,102,103,205,0,1,21.50,9.5
"2011","Hagworthingham BUA","E34000298","Total",359,183,176,359,0,5,33.00,10.9
"2011","Salisbury District Hospital BUA","E34000299","Total",592,277,315,523,69,8,22.50,26.3
"2011","Yelling BUA","E34000300","Total",411,204,207,411,0,7,28.50,14.4
"2011","Somerton (Cherwell) BUA","E34000301","Total",305,143,162,305,0,6,20.50,14.9
"2011","Yarnton BUA","E34000302","Total",2545,1207,1338,2504,41,63,107.25,23.7
"2011","Fenstanton BUA","E34000303","Total",2639,1261,1378,2639,0,40,76.75,34.4
"2011","Metheringham BUA","E34000304","Total",3605,1739,1866,3575,30,46,106.00,34.0
"2011","Hurley (North Warwickshire) BUA","E34000305","Total",1339,667,672,1339,0,9,36.50,36.7
"2011","Hook (Hart) BUA","E34000306","Total",7934,3924,4010,7862,72,220,259.00,30.6
"2011","Bow Brickhill BUA","E34000307","Total",562,275,287,562,0,7,31.50,17.8
"2011","Burton Overy BUA","E34000308","Total",440,210,230,440,0,3,26.75,16.4
"2011","Hurst Green (Ribble Valley) BUA","E34000309","Total",265,122,143,264,1,8,23.50,11.3
"2011","Rainworth BUA","E34000310","Total",7693,3770,3923,7586,107,60,184.50,41.7
"2011","Quadring BUA","E34000311","Total",961,464,497,932,29,13,50.75,18.9
"2011","Robertson Barracks BUA","E34000312","Total",589,428,161,312,277,4,39.50,14.9
"2011","Beverley BUA","E34000313","Total",30587,14679,15908,30243,344,512,723.50,42.3
"2011","Clavering BUA","E34000314","Total",882,413,469,882,0,21,71.00,12.4
"2011","Tedburn St Mary BUA","E34000316","Total",703,349,354,703,0,4,30.25,23.2
"2011","Lighthorne BUA","E34000317","Total",361,179,182,359,2,7,24.75,14.6
"2011","Scotton (Harrogate) BUA","E34000318","Total",814,391,423,814,0,16,41.50,19.6
"2011","Abingworth BUA","E34000319","Total",697,364,333,695,2,14,36.75,19.0
"2011","Tasburgh BUA","E34000320","Total",910,453,457,910,0,8,39.75,22.9
"2011","Portesham BUA","E34000321","Total",566,287,279,566,0,8,32.25,17.6
"2011","Tolleshunt Major BUA","E34000322","Total",393,179,214,345,48,3,25.00,15.7
"2011","University of Lancaster BUA","E34000323","Total",5110,2467,2643,316,4794,100,44.75,114.2
"2011","Great Comberton BUA","E34000324","Total",300,146,154,300,0,7,30.25,9.9
"2011","High Cross BUA","E34000325","Total",340,172,168,340,0,2,28.00,12.1
"2011","Sherborne St John BUA","E34000326","Total",1186,572,614,1161,25,27,59.75,19.8
"2011","Haverhill BUA","E34000327","Total",27041,13474,13567,26903,138,187,697.00,38.8
"2011","Market Lavington BUA","E34000328","Total",2482,1235,1247,2405,77,62,95.75,25.9
"2011","Pensford BUA","E34000329","Total",870,423,447,870,0,13,38.75,22.5
"2011","Piddington BUA","E34000330","Total",370,184,186,370,0,7,24.25,15.3
"2011","Brandeston BUA","E34000331","Total",296,144,152,272,24,7,22.00,13.5
"2011","Foxley BUA","E34000332","Total",285,135,150,285,0,5,22.75,12.5
"2011","Berinsfield BUA","E34000333","Total",2806,1389,1417,2806,0,11,58.50,48.0
"2011","Harlton BUA","E34000334","Total",308,154,154,308,0,7,26.75,11.5
"2011","Brierley BUA","E34000335","Total",2595,1259,1336,2572,23,17,67.75,38.3
"2011","Hilton (Stockton-on-Tees) BUA","E34000336","Total",374,184,190,374,0,6,22.75,16.4
"2011","Markyate BUA","E34000337","Total",2912,1442,1470,2912,0,33,68.50,42.5
"2011","Henfield BUA","E34000338","Total",4799,2213,2586,4679,120,86,144.50,33.2
"2011","Lacock BUA","E34000339","Total",320,151,169,313,7,4,21.25,15.1
"2011","Dorrington (Shropshire) BUA","E34000340","Total",613,295,318,613,0,6,25.00,24.5
"2011","South Brent BUA","E34000341","Total",2559,1182,1377,2481,78,38,75.75,33.8
"2011","RAF Tern Hill BUA","E34000342","Total",602,456,146,278,324,1,37.50,16.1
"2011","Littlebury BUA","E34000343","Total",592,302,290,591,1,18,27.75,21.3
"2011","Chipping Warden BUA","E34000344","Total",537,265,272,537,0,4,24.00,22.4
"2011","Warmington (East Northamptonshire) BUA","E34000345","Total",939,478,461,939,0,26,48.75,19.3
"2011","Widford BUA","E34000346","Total",534,256,278,510,24,16,25.25,21.1
"2011","Barkway BUA","E34000347","Total",775,374,401,775,0,9,35.50,21.8
"2011","Sheriff Hutton BUA","E34000348","Total",1019,485,534,1019,0,22,38.50,26.5
"2011","Airmyn BUA","E34000349","Total",768,373,395,751,17,11,33.50,22.9
"2011","Over Wallop BUA","E34000350","Total",981,478,503,948,33,13,73.00,13.4
"2011","Washbrook BUA","E34000351","Total",517,251,266,517,0,11,21.75,23.8
"2011","Rolleston BUA","E34000352","Total",312,151,161,312,0,14,23.00,13.6
"2011","St Leonards BUA","E34000353","Total",5984,2896,3088,5785,199,91,505.75,11.8
"2011","Mullion BUA","E34000354","Total",1955,944,1011,1955,0,26,86.25,22.7
"2011","Ingleton BUA","E34000355","Total",1772,834,938,1729,43,16,70.50,25.1
"2011","Wootton (Isle of Wight) BUA","E34000356","Total",4231,2023,2208,4108,123,61,241.00,17.6
"2011","Kingston (Canterbury) BUA","E34000357","Total",471,224,247,463,8,6,30.75,15.3
"2011","Luddenden Foot BUA","E34000358","Total",2190,1057,1133,2175,15,19,62.25,35.2
"2011","North Tawton BUA","E34000359","Total",1630,815,815,1630,0,18,59.50,27.4
"2011","Upton (Wakefield) BUA","E34000360","Total",5874,2914,2960,5860,14,59,134.50,43.7
"2011","Stutton BUA","E34000361","Total",599,273,326,599,0,29,39.25,15.3
"2011","Broughton Moor BUA","E34000362","Total",783,378,405,783,0,3,24.25,32.3
"2011","Wincanton BUA","E34000363","Total",5435,2640,2795,5362,73,83,187.25,29.0
"2011","Polgooth BUA","E34000364","Total",1155,557,598,1124,31,15,51.00,22.6
"2011","Bladon BUA","E34000365","Total",898,431,467,898,0,18,38.00,23.6
"2011","Broadwas BUA","E34000366","Total",318,165,153,318,0,8,27.25,11.7
"2011","Hayton (East Riding of Yorkshire) BUA","E34000367","Total",193,98,95,193,0,6,22.25,8.7
"2011","Mells BUA","E34000368","Total",638,326,312,636,2,12,41.50,15.4
"2011","Bittaford BUA","E34000369","Total",849,412,437,849,0,12,41.25,20.6
"2011","Leavenheath BUA","E34000370","Total",1039,504,535,1039,0,19,44.25,23.5
"2011","Wixams BUA","E34000371","Total",662,310,352,633,29,9,42.50,15.6
"2011","Broadway BUA","E34000372","Total",2540,1172,1368,2492,48,39,120.50,21.1
"2011","Sewardstone BUA","E34000373","Total",653,330,323,595,58,5,66.00,9.9
"2011","Hardwick (South Cambridgeshire) BUA","E34000374","Total",2670,1312,1358,2670,0,51,91.75,29.1
"2011","Upper Poppleton BUA","E34000375","Total",3451,1630,1821,3430,21,81,125.50,27.5
"2011","Brereton Heath BUA","E34000376","Total",411,206,205,411,0,5,30.50,13.5
"2011","Cudham BUA","E34000377","Total",362,179,183,362,0,8,30.25,12.0
"2011","Barnack BUA","E34000378","Total",752,368,384,752,0,23,52.50,14.3
"2011","Sutton (East Cambridgeshire) BUA","E34000379","Total",3816,1873,1943,3816,0,39,121.25,31.5
"2011","Pulham St Mary BUA","E34000380","Total",770,409,361,764,6,8,34.50,22.3
"2011","Heckington BUA","E34000381","Total",3823,1877,1946,3787,36,50,156.00,24.5
"2011","Cloughton BUA","E34000382","Total",687,338,349,680,7,16,20.25,33.9
"2011","Castleton (High Peak) BUA","E34000383","Total",642,303,339,635,7,13,27.75,23.1
"2011","Upper End BUA","E34000384","Total",673,349,324,673,0,2,20.25,33.2
"2011","Clapham (Bedford) BUA","E34000385","Total",4560,2161,2399,4381,179,55,133.75,34.1
"2011","Clyst Honiton BUA","E34000386","Total",304,152,152,304,0,3,232.50,1.3
"2011","Chinnor BUA","E34000387","Total",5473,2658,2815,5445,28,80,139.50,39.2
"2011","Knayton BUA","E34000388","Total",318,153,165,318,0,9,20.50,15.5
"2011","Ninfield BUA","E34000389","Total",1307,629,678,1290,17,28,65.00,20.1
"2011","Kingsdon BUA","E34000390","Total",303,146,157,303,0,8,23.00,13.2
"2011","Dockenfield BUA","E34000391","Total",399,193,206,399,0,13,43.75,9.1
"2011","West Perry BUA","E34000392","Total",573,290,283,573,0,4,25.00,22.9
"2011","Long Clawson BUA","E34000393","Total",1066,521,545,1066,0,16,50.25,21.2
"2011","Banks BUA","E34000394","Total",3572,1739,1833,3543,29,30,176.50,20.2
"2011","Crondall BUA","E34000395","Total",1239,599,640,1239,0,28,66.50,18.6
"2011","Thurcroft BUA","E34000396","Total",5115,2533,2582,5094,21,28,128.25,39.9
"2011","Pickhill BUA","E34000397","Total",401,194,207,398,3,12,25.75,15.6
"2011","Long Marston (Dacorum) BUA","E34000398","Total",762,378,384,762,0,20,20.50,37.2
"2011","Tregadillett BUA","E34000399","Total",543,268,275,543,0,4,21.75,25.0
"2011","Heddon-on-the-Wall BUA","E34000400","Total",1318,649,669,1318,0,17,45.75,28.8
"2011","Otterburn BUA","E34000401","Total",654,334,320,633,21,14,27.50,23.8
"2011","Peasenhall BUA","E34000402","Total",517,263,254,517,0,12,42.00,12.3
"2011","Exmouth BUA","E34000403","Total",34432,16241,18191,33787,645,375,856.50,40.2
"2011","Scayne's Hill BUA","E34000404","Total",1002,489,513,1002,0,22,51.50,19.5
"2011","Norton (Doncaster) BUA","E34000405","Total",2384,1170,1214,2336,48,18,59.00,40.4
"2011","Vernham Dean BUA","E34000406","Total",552,275,277,552,0,32,20.75,26.6
"2011","Bishop Monkton BUA","E34000407","Total",778,372,406,778,0,19,40.25,19.3
"2011","Rufforth BUA","E34000408","Total",633,309,324,633,0,13,73.25,8.6
"2011","Bolton-le-Sands BUA","E34000409","Total",6995,3326,3669,6833,162,116,239.75,29.2
"2011","Upper Bucklebury BUA","E34000410","Total",991,489,502,986,5,31,56.25,17.6
"2011","Marden (Maidstone) BUA","E34000411","Total",2265,1106,1159,2265,0,29,98.25,23.1
"2011","Riviere Towans BUA","E34000412","Total",253,120,133,253,0,0,31.00,8.2
"2011","Manby BUA","E34000413","Total",1479,741,738,1479,0,18,107.25,13.8
"2011","Aston Clinton BUA","E34000414","Total",4216,2059,2157,4205,11,93,155.25,27.2
"2011","Cockwood BUA","E34000415","Total",349,177,172,349,0,9,21.75,16.0
"2011","Crediton BUA","E34000416","Total",7835,3837,3998,7699,136,87,246.50,31.8
"2011","Stainburn BUA","E34000417","Total",1364,690,674,1357,7,22,46.50,29.3
"2011","Beeford BUA","E34000418","Total",1078,534,544,1078,0,12,48.00,22.5
"2011","Up Nately BUA","E34000419","Total",333,160,173,317,16,12,28.50,11.7
"2011","Wickhambrook BUA","E34000420","Total",554,271,283,554,0,7,36.25,15.3
"2011","Winster BUA","E34000421","Total",600,296,304,600,0,6,22.75,26.4
"2011","Langdane Wood BUA","E34000422","Total",145,76,69,145,0,2,23.00,6.3
"2011","Moreton-in-Marsh BUA","E34000423","Total",3493,1636,1857,3455,38,44,109.75,31.8
"2011","Thurlby BUA","E34000424","Total",2153,1100,1053,2153,0,49,97.00,22.2
"2011","Lowick BUA","E34000425","Total",373,194,179,373,0,9,25.75,14.5
"2011","Brookmans Park BUA","E34000426","Total",3561,1737,1824,3561,0,107,191.75,18.6
"2011","Spilsby BUA","E34000427","Total",3440,1617,1823,3387,53,25,130.75,26.3
"2011","Hamstreet BUA","E34000428","Total",1555,738,817,1536,19,16,47.50,32.7
"2011","Bassingham BUA","E34000429","Total",1425,692,733,1399,26,24,62.25,22.9
"2011","Henley-on-Thames BUA","E34000430","Total",11494,5357,6137,11394,100,237,397.25,28.9
"2011","Cannington BUA","E34000431","Total",2002,976,1026,1948,54,31,83.25,24.0
"2011","Edingale BUA","E34000432","Total",632,302,330,632,0,11,20.75,30.5
"2011","Ripponden BUA","E34000433","Total",4665,2279,2386,4582,83,81,158.50,29.4
"2011","Edge BUA","E34000434","Total",245,119,126,245,0,3,23.75,10.3
"2011","Great Longstone BUA","E34000435","Total",843,420,423,843,0,32,42.50,19.8
"2011","Brompton BUA","E34000436","Total",1848,914,934,1848,0,29,63.25,29.2
"2011","Donington BUA","E34000437","Total",2805,1358,1447,2805,0,29,127.25,22.0
"2011","Eckington BUA","E34000438","Total",1217,594,623,1217,0,33,55.25,22.0
"2011","East Farndon BUA","E34000439","Total",307,145,162,307,0,17,23.75,12.9
"2011","Snodland BUA","E34000440","Total",10211,4941,5270,10122,89,64,220.50,46.3
"2011","Kinsley BUA","E34000441","Total",4287,2098,2189,4177,110,17,125.25,34.2
"2011","Loddington BUA","E34000442","Total",520,242,278,520,0,21,24.75,21.0
"2011","Longhorsley BUA","E34000443","Total",887,423,464,887,0,25,31.25,28.4
"2011","South Kelsey BUA","E34000444","Total",604,315,289,604,0,13,37.25,16.2
"2011","Chulmleigh BUA","E34000445","Total",1017,483,534,1017,0,22,47.75,21.3
"2011","Ashley Green BUA","E34000446","Total",682,353,329,682,0,31,25.25,27.0
"2011","Brimpton BUA","E34000447","Total",325,170,155,325,0,13,20.75,15.7
"2011","Broughton (Test Valley) BUA","E34000448","Total",1003,507,496,1003,0,33,78.75,12.7
"2011","Goldhanger BUA","E34000449","Total",654,333,321,654,0,12,36.00,18.2
"2011","East Markham BUA","E34000450","Total",1160,573,587,1160,0,23,65.75,17.6
"2011","Bere Alston BUA","E34000451","Total",2164,1045,1119,2139,25,24,67.75,31.9
"2011","High Easter BUA","E34000452","Total",754,367,387,754,0,27,22.50,33.5
"2011","Arborfield BUA","E34000453","Total",334,176,158,334,0,12,42.00,8.0
"2011","Armitage BUA","E34000454","Total",4650,2304,2346,4631,19,48,130.75,35.6
"2011","Burgh St Peter BUA","E34000455","Total",274,149,125,274,0,5,37.00,7.4
"2011","Coggeshall BUA","E34000456","Total",4727,2278,2449,4724,3,78,128.50,36.8
"2011","Earsham BUA","E34000457","Total",882,419,463,848,34,11,39.00,22.6
"2011","Meltham BUA","E34000458","Total",7836,3813,4023,7776,60,84,216.25,36.2
"2011","Sutton on Trent BUA","E34000459","Total",1171,581,590,1171,0,24,72.00,16.3
"2011","Wheldrake BUA","E34000460","Total",1984,940,1044,1944,40,34,65.75,30.2
"2011","Great Malgraves BUA","E34000461","Total",249,128,121,249,0,2,49.25,5.1
"2011","Gooderstone BUA","E34000462","Total",363,169,194,363,0,2,35.00,10.4
"2011","Needham Market BUA","E34000463","Total",4528,2167,2361,4499,29,46,141.25,32.1
"2011","Worton BUA","E34000464","Total",624,302,322,624,0,20,27.75,22.5
"2011","Sutton Common BUA","E34000465","Total",1425,915,510,1070,355,16,175.25,8.1
"2011","Goonhavern BUA","E34000466","Total",738,348,390,738,0,10,52.50,14.1
"2011","Garsington BUA","E34000467","Total",1333,666,667,1333,0,21,60.50,22.0
"2011","Flamstead BUA","E34000468","Total",990,498,492,990,0,21,59.00,16.8
"2011","Minehead BUA","E34000469","Total",11981,5635,6346,10834,1147,95,419.25,28.6
"2011","Charsfield BUA","E34000470","Total",355,175,180,355,0,14,26.25,13.5
"2011","Constantine BUA","E34000471","Total",819,379,440,792,27,7,39.50,20.7
"2011","Great Paxton BUA","E34000472","Total",1007,511,496,1007,0,16,32.00,31.5
"2011","Daventry BUA","E34000473","Total",23879,11772,12107,23698,181,213,747.75,31.9
"2011","Lamarsh BUA","E34000474","Total",187,96,91,187,0,1,21.75,8.6
"2011","Durfold Wood BUA","E34000475","Total",374,183,191,374,0,15,31.50,11.9
"2011","Outwood BUA","E34000476","Total",443,223,220,443,0,12,34.50,12.8
"2011","Kilmeston BUA","E34000477","Total",276,138,138,276,0,10,23.00,12.0
"2011","Knapton BUA","E34000478","Total",364,184,180,364,0,5,25.25,14.4
"2011","Probus BUA","E34000479","Total",1906,908,998,1906,0,21,56.50,33.7
"2011","Newton-with-Scales BUA","E34000480","Total",1544,752,792,1544,0,22,41.00,37.7
"2011","Naunton BUA","E34000481","Total",352,171,181,352,0,8,28.75,12.2
"2011","Keyworth BUA","E34000482","Total",6733,3275,3458,6733,0,102,226.25,29.8
"2011","Deanland Wood Park BUA","E34000483","Total",623,276,347,623,0,2,21.00,29.7
"2011","Downderry BUA","E34000484","Total",745,361,384,745,0,10,48.50,15.4
"2011","Wimblington BUA","E34000485","Total",4239,2098,2141,4226,13,33,189.00,22.4
"2011","Marazion BUA","E34000486","Total",1294,601,693,1237,57,9,48.25,26.8
"2011","Eccles BUA","E34000487","Total",1670,833,837,1670,0,15,30.00,55.7
"2011","Penton Mewsey BUA","E34000488","Total",412,201,211,362,50,18,35.25,11.7
"2011","Bonby BUA","E34000489","Total",532,261,271,532,0,7,32.50,16.4
"2011","Deal BUA","E34000490","Total",30555,14649,15906,30047,508,298,681.75,44.8
"2011","Water Orton BUA","E34000491","Total",3444,1683,1761,3410,34,43,93.50,36.8
"2011","Tugby BUA","E34000492","Total",330,161,169,330,0,18,23.00,14.3
"2011","Quainton BUA","E34000493","Total",913,428,485,913,0,23,42.00,21.7
"2011","Rockland All Saints BUA","E34000494","Total",374,198,176,367,7,5,27.00,13.9
"2011","Chartham Hatch BUA","E34000495","Total",482,247,235,482,0,10,20.25,23.8
"2011","West Grimstead BUA","E34000496","Total",223,104,119,223,0,9,22.50,9.9
"2011","Berrynarbor BUA","E34000497","Total",802,396,406,794,8,11,58.75,13.7
"2011","Settrington BUA","E34000498","Total",316,161,155,316,0,10,27.50,11.5
"2011","Hythe BUA","E34000499","Total",20201,9786,10415,20122,79,202,570.50,35.4
"2011","North Nibley BUA","E34000500","Total",444,210,234,441,3,10,23.25,19.1
"2011","Compton Martin BUA","E34000501","Total",508,241,267,508,0,11,28.00,18.1
"2011","Hutton BUA","E34000502","Total",560,273,287,560,0,13,31.50,17.8
"2011","Wolvey BUA","E34000503","Total",845,424,421,845,0,9,31.25,27.0
"2011","Ibstock BUA","E34000504","Total",5650,2809,2841,5598,52,62,145.50,38.8
"2011","Bucklesham BUA","E34000505","Total",526,255,271,526,0,14,23.25,22.6
"2011","Halstock BUA","E34000506","Total",546,275,271,544,2,8,21.25,25.7
"2011","Leigh Sinton BUA","E34000507","Total",766,380,386,766,0,16,33.50,22.9
"2011","Market Deeping BUA","E34000508","Total",13574,6530,7044,13487,87,261,388.50,34.9
"2011","Horncastle BUA","E34000509","Total",6815,3290,3525,6726,89,64,281.00,24.3
"2011","Bodenham Moor BUA","E34000510","Total",557,272,285,557,0,7,36.75,15.2
"2011","Featherstone (South Staffordshire) BUA","E34000511","Total",3846,1872,1974,3837,9,38,75.75,50.8
"2011","High Spen BUA","E34000512","Total",1364,646,718,1301,63,8,38.50,35.4
"2011","Aylesbeare BUA","E34000513","Total",583,285,298,583,0,10,20.25,28.8
"2011","Pucklechurch BUA","E34000514","Total",2364,1220,1144,2251,113,19,85.25,27.7
"2011","Blackthorn BUA","E34000515","Total",317,160,157,317,0,11,27.00,11.7
"2011","Corton BUA","E34000516","Total",244,115,129,244,0,8,20.50,11.9
"2011","Haxey BUA","E34000517","Total",2153,1026,1127,2106,47,35,94.50,22.8
"2011","Long Preston BUA","E34000518","Total",742,364,378,738,4,18,23.75,31.2
"2011","Dymock BUA","E34000519","Total",592,287,305,568,24,6,20.75,28.5
"2011","Alderbury BUA","E34000520","Total",2223,1022,1201,2218,5,53,93.50,23.8
"2011","Glastonbury BUA","E34000521","Total",8471,4077,4394,8301,170,130,298.00,28.4
"2011","Cuddesdon BUA","E34000522","Total",511,250,261,485,26,14,22.50,22.7
"2011","Dunsfold BUA","E34000523","Total",317,151,166,312,5,11,27.50,11.5
"2011","West Horsley BUA","E34000524","Total",1276,599,677,1256,20,54,100.00,12.8
"2011","Little Dunmow BUA","E34000525","Total",2190,1080,1110,2190,0,35,34.25,63.9
"2011","Handcross BUA","E34000526","Total",1027,511,516,1027,0,13,34.75,29.6
"2011","Witham BUA","E34000527","Total",25353,12364,12989,25173,180,227,622.50,40.7
"2011","Stoneleigh BUA","E34000528","Total",341,173,168,341,0,9,20.25,16.8
"2011","Pitchcombe BUA","E34000529","Total",232,108,124,232,0,4,21.25,10.9
"2011","Fittleworth BUA","E34000530","Total",681,325,356,681,0,22,52.25,13.0
"2011","East Barkwith BUA","E34000531","Total",373,184,189,367,6,6,23.75,15.7
"2011","Littlebourne BUA","E34000532","Total",1529,699,830,1474,55,27,63.25,24.2
"2011","Gaddesby BUA","E34000533","Total",381,183,198,381,0,6,34.75,11.0
"2011","Lode BUA","E34000534","Total",704,353,351,704,0,19,30.50,23.1
"2011","East Halton BUA","E34000535","Total",626,306,320,626,0,5,46.25,13.5
"2011","Skellingthorpe BUA","E34000536","Total",3359,1636,1723,3275,84,25,127.00,26.4
"2011","Tintinhull BUA","E34000537","Total",902,457,445,890,12,15,47.00,19.2
"2011","Alvington BUA","E34000538","Total",506,247,259,506,0,4,24.00,21.1
"2011","Comberton BUA","E34000539","Total",2346,1126,1220,2346,0,63,92.50,25.4
"2011","Bishop's Itchington BUA","E34000540","Total",1940,972,968,1940,0,18,50.25,38.6
"2011","West Pennard BUA","E34000541","Total",670,331,339,632,38,20,36.25,18.5
"2011","Goathland BUA","E34000542","Total",265,128,137,256,9,0,31.00,8.5
"2011","Ashley (East Cambridgeshire) BUA","E34000543","Total",749,379,370,749,0,5,29.75,25.2
"2011","Hepscott BUA","E34000544","Total",417,196,221,417,0,19,47.50,8.8
"2011","Horndon on the Hill BUA","E34000545","Total",1596,785,811,1596,0,23,67.25,23.7
"2011","Barrington (South Cambridgeshire) BUA","E34000546","Total",993,471,522,993,0,21,77.25,12.9
"2011","Stickford BUA","E34000547","Total",497,253,244,497,0,9,47.00,10.6
"2011","North Scarle BUA","E34000548","Total",640,314,326,632,8,11,30.25,21.2
"2011","Watlington (South Oxfordshire) BUA","E34000549","Total",2459,1143,1316,2414,45,45,79.25,31.0
"2011","Holmes Chapel BUA","E34000550","Total",5605,2699,2906,5576,29,145,199.00,28.2
"2011","Minstead BUA","E34000551","Total",326,158,168,312,14,6,32.00,10.2
"2011","Barrow upon Humber BUA","E34000552","Total",2820,1381,1439,2744,76,30,102.50,27.5
"2011","Whaley Bridge BUA","E34000553","Total",5140,2547,2593,5132,8,86,177.75,28.9
"2011","Tallington BUA","E34000554","Total",497,230,267,460,37,9,22.50,22.1
"2011","Milford on Sea BUA","E34000555","Total",4348,2029,2319,4268,80,58,275.50,15.8
"2011","Chatburn BUA","E34000556","Total",1102,526,576,1048,54,10,39.75,27.7
"2011","Swardeston BUA","E34000557","Total",619,288,331,619,0,13,28.75,21.5
"2011","Wrangle BUA","E34000558","Total",887,440,447,867,20,8,63.25,14.0
"2011","Tewin BUA","E34000559","Total",864,424,440,864,0,30,30.25,28.6
"2011","Cley next the Sea BUA","E34000560","Total",437,209,228,437,0,12,31.00,14.1
"2011","Finningham BUA","E34000561","Total",480,239,241,480,0,12,32.00,15.0
"2011","Allington BUA","E34000562","Total",586,287,299,586,0,13,31.25,18.8
"2011","Micklefield BUA","E34000563","Total",930,473,457,930,0,3,26.25,35.4
"2011","Sherburn Hill BUA","E34000564","Total",1202,577,625,1202,0,11,34.25,35.1
"2011","Oakley (Aylesbury Vale) BUA","E34000565","Total",1007,508,499,1007,0,20,45.50,22.1
"2011","Sutton-on-the-Forest BUA","E34000566","Total",539,267,272,539,0,22,35.75,15.1
"2011","Gerrards Cross BUA","E34000567","Total",20633,9874,10759,20149,484,716,900.00,22.9
"2011","Small Dole BUA","E34000568","Total",796,390,406,796,0,12,56.50,14.1
"2011","Kingsand BUA","E34000569","Total",647,314,333,647,0,13,25.25,25.6
"2011","Hemswell Cliff BUA","E34000570","Total",677,345,332,622,55,5,62.00,10.9
"2011","Ipplepen BUA","E34000571","Total",2143,994,1149,2125,18,32,76.50,28.0
"2011","Duxford Airfield BUA","E34000572","Total",676,344,332,676,0,9,57.50,11.8
"2011","Ulverston BUA","E34000573","Total",11356,5536,5820,11225,131,153,340.75,33.3
"2011","Chapeltown BUA","E34000574","Total",23056,11242,11814,22894,162,171,513.50,44.9
"2011","Olveston BUA","E34000575","Total",1015,491,524,1014,1,22,38.25,26.5
"2011","Walkington BUA","E34000576","Total",1769,849,920,1767,2,43,81.00,21.8
"2011","Abinger Hammer BUA","E34000577","Total",257,125,132,257,0,5,21.25,12.1
"2011","Barrowden BUA","E34000578","Total",506,244,262,506,0,12,34.00,14.9
"2011","Darite BUA","E34000579","Total",326,167,159,326,0,5,27.50,11.9
"2011","Houghton Conquest BUA","E34000580","Total",1311,647,664,1311,0,18,46.50,28.2
"2011","Maxey BUA","E34000581","Total",708,354,354,708,0,19,45.50,15.6
"2011","Barton (South Cambridgeshire) BUA","E34000582","Total",846,406,440,846,0,22,53.50,15.8
"2011","Upper Saxondale BUA","E34000583","Total",923,473,450,923,0,25,25.75,35.8
"2011","Creaton BUA","E34000584","Total",503,263,240,503,0,13,28.75,17.5
"2011","Mousehole BUA","E34000585","Total",697,344,353,697,0,9,25.50,27.3
"2011","Frieth BUA","E34000586","Total",571,275,296,571,0,21,40.25,14.2
"2011","Winteringham BUA","E34000587","Total",1000,498,502,1000,0,18,49.50,20.2
"2011","Cleeve Prior BUA","E34000588","Total",561,271,290,561,0,12,34.75,16.1
"2011","Hornsea BUA","E34000589","Total",8432,4037,4395,8274,158,106,277.75,30.4
"2011","Full Sutton BUA","E34000590","Total",1072,840,232,468,604,7,38.75,27.7
"2011","Wem BUA","E34000591","Total",5870,2805,3065,5731,139,76,178.75,32.8
"2011","Horham BUA","E34000592","Total",305,153,152,305,0,2,21.50,14.2
"2011","White-le-Head BUA","E34000593","Total",1271,631,640,1271,0,12,24.75,51.4
"2011","Hathersage BUA","E34000594","Total",2018,954,1064,1969,49,53,80.25,25.1
"2011","Tolleshunt D'Arcy BUA","E34000595","Total",825,404,421,825,0,14,39.25,21.0
"2011","Silsoe BUA","E34000596","Total",1791,868,923,1771,20,50,67.50,26.5
"2011","Loughborough BUA","E34000597","Total",59932,31067,28865,53792,6140,956,1448.75,41.4
"2011","Burcot BUA","E34000598","Total",361,180,181,286,75,8,28.00,12.9
"2011","West Camel BUA","E34000599","Total",459,229,230,459,0,9,25.75,17.8
"2011","Pensilva BUA","E34000600","Total",1663,801,862,1663,0,11,75.50,22.0
"2011","Cardington BUA","E34000601","Total",288,123,165,288,0,6,29.75,9.7
"2011","Great Easton (Uttlesford) BUA","E34000602","Total",365,172,193,349,16,9,28.25,12.9
"2011","Hadham Cross BUA","E34000603","Total",1207,583,624,1207,0,32,60.00,20.1
"2011","Skipsea BUA","E34000604","Total",693,338,355,693,0,2,23.50,29.5
"2011","Graveley BUA","E34000605","Total",289,155,134,289,0,6,21.75,13.3
"2011","Great Livermere BUA","E34000606","Total",226,103,123,226,0,2,20.25,11.2
"2011","Earl Soham BUA","E34000607","Total",455,237,218,455,0,16,29.00,15.7
"2011","Crow Hill Housing Estate BUA","E34000608","Total",1033,518,515,1001,32,7,21.50,48.0
"2011","Woolfardisworthy BUA","E34000609","Total",783,389,394,783,0,7,23.75,33.0
"2011","Nash BUA","E34000610","Total",417,213,204,417,0,13,20.25,20.6
"2011","Plumpton BUA","E34000611","Total",341,184,157,255,86,35,28.50,12.0
"2011","Holme Hale BUA","E34000612","Total",494,232,262,494,0,5,20.25,24.4
"2011","Great Bedwyn BUA","E34000613","Total",1175,565,610,1175,0,26,39.25,29.9
"2011","Thurgarton BUA","E34000614","Total",440,222,218,440,0,16,31.00,14.2
"2011","Clifton upon Teme BUA","E34000615","Total",695,338,357,695,0,9,23.25,29.9
"2011","Eastoft BUA","E34000616","Total",431,219,212,431,0,0,29.50,14.6
"2011","Ulcombe BUA","E34000617","Total",575,289,286,575,0,8,25.25,22.8
"2011","Somerby BUA","E34000618","Total",548,278,270,548,0,15,26.75,20.5
"2011","Himley BUA","E34000619","Total",462,209,253,379,83,2,21.75,21.2
"2011","Geldeston BUA","E34000620","Total",397,201,196,397,0,7,25.00,15.9
"2011","Cocklake BUA","E34000621","Total",419,205,214,419,0,7,24.50,17.1
"2011","Meopham (North) BUA","E34000622","Total",3112,1494,1618,3083,29,54,79.00,39.4
"2011","Fence BUA","E34000623","Total",1459,716,743,1459,0,21,48.75,29.9
"2011","Great Easton (Harborough) BUA","E34000624","Total",671,320,351,671,0,20,36.50,18.4
"2011","Helpston BUA","E34000625","Total",981,472,509,981,0,19,47.75,20.5
"2011","Morley St Botolph BUA","E34000626","Total",282,132,150,282,0,5,20.75,13.6
"2011","Glinton BUA","E34000627","Total",1740,844,896,1719,21,35,68.50,25.4
"2011","Maghull BUA","E34000628","Total",26997,13119,13878,26369,628,261,669.75,40.3
"2011","Marsh Green BUA","E34000629","Total",332,180,152,300,32,10,23.75,14.0
"2011","Bramhope BUA","E34000630","Total",3382,1611,1771,3354,28,84,150.75,22.4
"2011","Weeting BUA","E34000631","Total",1839,917,922,1839,0,13,71.00,25.9
"2011","Claypole BUA","E34000632","Total",1382,658,724,1382,0,31,44.25,31.2
"2011","Southport BUA","E34000633","Total",91703,43794,47909,89678,2025,1129,2292.75,40.0
"2011","Redhill (North Somerset) BUA","E34000634","Total",308,148,160,308,0,3,29.25,10.5
"2011","Wilmcote BUA","E34000635","Total",1092,524,568,1089,3,15,61.25,17.8
"2011","Weedon BUA","E34000636","Total",275,129,146,275,0,14,21.50,12.8
"2011","Holtby BUA","E34000637","Total",166,80,86,166,0,3,20.25,8.2
"2011","South Creake BUA","E34000638","Total",516,264,252,516,0,11,20.50,25.2
"2011","Church Brampton BUA","E34000639","Total",289,146,143,289,0,11,38.75,7.5
"2011","Buckden BUA","E34000640","Total",2677,1285,1392,2633,44,48,102.25,26.2
"2011","Monxton BUA","E34000641","Total",530,261,269,530,0,23,31.75,16.7
"2011","Barton-under-Needwood BUA","E34000642","Total",3796,1819,1977,3794,2,86,110.25,34.4
"2011","Calver BUA","E34000643","Total",1127,541,586,1096,31,24,71.25,15.8
"2011","Guilden Morden BUA","E34000644","Total",986,485,501,986,0,23,53.00,18.6
"2011","Thornbury BUA","E34000645","Total",11687,5753,5934,11539,148,214,303.25,38.5
"2011","Hose BUA","E34000646","Total",580,293,287,580,0,15,22.50,25.8
"2011","Shipton (Cotswold) BUA","E34000647","Total",365,189,176,362,3,14,29.25,12.5
"2011","Heybridge Basin BUA","E34000648","Total",760,385,375,759,1,13,20.25,37.5
"2011","Scarcroft BUA","E34000649","Total",1194,568,626,1194,0,34,91.25,13.1
"2011","Stoney Stanton BUA","E34000650","Total",3793,1875,1918,3791,2,47,101.25,37.5
"2011","Hampton Magna BUA","E34000651","Total",1725,851,874,1725,0,33,49.75,34.7
"2011","Ewshot BUA","E34000652","Total",635,296,339,602,33,25,54.75,11.6
"2011","Tuddenham BUA","E34000653","Total",423,217,206,423,0,4,26.25,16.1
"2011","Oxhill BUA","E34000654","Total",305,135,170,305,0,14,31.00,9.8
"2011","Barroway Drove BUA","E34000655","Total",391,201,190,391,0,3,31.25,12.5
"2011","Street BUA","E34000656","Total",12911,6299,6612,11979,932,166,381.25,33.9
"2011","Shobdon BUA","E34000657","Total",656,335,321,656,0,6,38.75,16.9
"2011","West Dean BUA","E34000658","Total",252,124,128,252,0,13,30.75,8.2
"2011","Thropton BUA","E34000659","Total",458,220,238,458,0,9,26.25,17.4
"2011","Caunton BUA","E34000660","Total",483,233,250,483,0,8,30.75,15.7
"2011","Ditchling BUA","E34000661","Total",1476,728,748,1476,0,40,80.75,18.3
"2011","Middleton-on-the-Wolds BUA","E34000662","Total",825,412,413,825,0,15,33.00,25.0
"2011","Hallow BUA","E34000663","Total",1219,590,629,1219,0,17,47.50,25.7
"2011","Emberton BUA","E34000664","Total",315,156,159,315,0,8,26.50,11.9
"2011","Church Lench BUA","E34000665","Total",311,156,155,311,0,4,35.00,8.9
"2011","Bishop Sutton BUA","E34000666","Total",1193,575,618,1193,0,34,52.50,22.7
"2011","Great Brickhill BUA","E34000667","Total",817,390,427,817,0,17,49.00,16.7
"2011","Levens BUA","E34000668","Total",843,412,431,843,0,11,45.00,18.7
"2011","Barwick in Elmet BUA","E34000669","Total",2509,1186,1323,2509,0,48,76.00,33.0
"2011","Mary Tavy BUA","E34000670","Total",840,392,448,805,35,20,47.00,17.9
"2011","Mickletown BUA","E34000671","Total",2679,1294,1385,2606,73,20,76.25,35.1
"2011","Hambleton (Selby) BUA","E34000672","Total",1859,902,957,1841,18,23,59.00,31.5
"2011","Wroxton BUA","E34000673","Total",326,164,162,314,12,7,27.25,12.0
"2011","Hibaldstow BUA","E34000674","Total",1974,961,1013,1973,1,20,74.50,26.5
"2011","Earby BUA","E34000675","Total",4538,2225,2313,4536,2,39,110.75,41.0
"2011","Patmore Heath BUA","E34000676","Total",324,161,163,324,0,11,32.00,10.1
"2011","Alresford BUA","E34000677","Total",2009,976,1033,1993,16,26,86.25,23.3
"2011","Trimdon Colliery BUA","E34000678","Total",2004,977,1027,1951,53,9,62.50,32.1
"2011","Utkinton BUA","E34000679","Total",382,189,193,382,0,8,27.75,13.8
"2011","Whitwell (Isle of Wight) BUA","E34000680","Total",619,304,315,619,0,13,39.75,15.6
"2011","Sinnington BUA","E34000681","Total",287,138,149,286,1,7,23.25,12.3
"2011","Bishop's Waltham BUA","E34000682","Total",6275,2969,3306,6215,60,105,162.50,38.6
"2011","Bildeston BUA","E34000683","Total",1054,534,520,1054,0,17,39.25,26.9
"2011","Steventon BUA","E34000684","Total",1485,732,753,1485,0,40,76.75,19.3
"2011","Upper Dicker BUA","E34000685","Total",551,301,250,295,256,25,29.00,19.0
"2011","Weston Turville BUA","E34000686","Total",2115,1016,1099,2067,48,62,87.50,24.2
"2011","Cold Norton BUA","E34000687","Total",1099,561,538,1095,4,28,59.50,18.5
"2011","Bordesley BUA","E34000688","Total",282,137,145,282,0,3,20.50,13.8
"2011","Newchurch BUA","E34000689","Total",380,190,190,380,0,3,31.25,12.2
"2011","Fleggburgh (Burgh St Margaret) BUA","E34000690","Total",754,362,392,754,0,7,50.50,14.9
"2011","Greywell BUA","E34000691","Total",237,118,119,237,0,11,24.50,9.7
"2011","Frome BUA","E34000692","Total",26203,12739,13464,25814,389,307,634.00,41.3
"2011","Walliswood BUA","E34000693","Total",354,175,179,353,1,15,35.00,10.1
"2011","Cantley BUA","E34000694","Total",504,245,259,504,0,11,53.75,9.4
"2011","Ketton BUA","E34000695","Total",1926,969,957,1881,45,49,132.75,14.5
"2011","Blagdon BUA","E34000696","Total",1001,480,521,1001,0,25,48.50,20.6
"2011","Bagshot BUA","E34000697","Total",5430,2700,2730,5346,84,84,172.75,31.4
"2011","Redbourne BUA","E34000698","Total",400,196,204,386,14,15,22.25,18.0
"2011","Holywell (Central Bedfordshire) BUA","E34000699","Total",636,319,317,615,21,25,44.00,14.5
"2011","East Grimstead BUA","E34000700","Total",311,152,159,311,0,20,25.25,12.3
"2011","Silver End BUA","E34000701","Total",3861,1912,1949,3795,66,23,85.50,45.2
"2011","Gallowstree Common BUA","E34000702","Total",421,219,202,421,0,16,24.25,17.4
"2011","Bayford BUA","E34000703","Total",466,231,235,466,0,13,20.50,22.7
"2011","Sherburn (Ryedale) BUA","E34000704","Total",830,400,430,830,0,5,45.25,18.3
"2011","Pelynt BUA","E34000705","Total",763,350,413,763,0,6,34.25,22.3
"2011","Thornham BUA","E34000706","Total",496,241,255,493,3,18,57.50,8.6
"2011","Waltham on the Wolds BUA","E34000707","Total",836,396,440,792,44,11,42.75,19.6
"2011","Stedham BUA","E34000708","Total",544,259,285,544,0,13,26.50,20.5
"2011","South Zeal BUA","E34000709","Total",912,452,460,895,17,18,50.25,18.1
"2011","Ross-on-Wye BUA","E34000710","Total",10582,5068,5514,10399,183,148,343.00,30.9
"2011","Lower Broadheath BUA","E34000711","Total",1406,696,710,1396,10,17,44.25,31.8
"2011","Storrington BUA","E34000712","Total",8618,4109,4509,8547,71,136,415.50,20.7
"2011","Hailey BUA","E34000713","Total",474,217,257,424,50,10,24.50,19.3
"2011","Hundon BUA","E34000714","Total",757,371,386,757,0,4,37.50,20.2
"2011","Littlethorpe BUA","E34000715","Total",346,172,174,346,0,5,20.75,16.7
"2011","Bleadon BUA","E34000716","Total",900,433,467,899,1,7,41.75,21.6
"2011","Weeton BUA","E34000717","Total",527,286,241,498,29,8,22.75,23.2
"2011","Caston BUA","E34000718","Total",443,220,223,443,0,7,45.50,9.7
"2011","Upper Dean BUA","E34000719","Total",418,207,211,418,0,10,26.75,15.6
"2011","Oakthorpe BUA","E34000720","Total",623,309,314,623,0,9,25.00,24.9
"2011","Delabole BUA","E34000721","Total",1647,803,844,1647,0,16,63.50,25.9
"2011","Timberland BUA","E34000722","Total",578,286,292,578,0,5,27.00,21.4
"2011","Eastington BUA","E34000723","Total",1108,534,574,1099,9,11,47.50,23.3
"2011","Taddington BUA","E34000724","Total",457,223,234,446,11,16,22.50,20.3
"2011","East Stour BUA","E34000725","Total",573,270,303,573,0,1,28.00,20.5
"2011","East Brent BUA","E34000726","Total",628,303,325,628,0,22,36.00,17.4
"2011","Bottisham BUA","E34000727","Total",2199,1033,1166,2016,183,40,76.25,28.8
"2011","Doveridge BUA","E34000728","Total",1622,809,813,1510,112,20,60.00,27.0
"2011","Great Lumley BUA","E34000729","Total",3684,1730,1954,3684,0,34,80.50,45.8
"2011","Badgers Mount BUA","E34000730","Total",656,316,340,656,0,13,33.00,19.9
"2011","Luxulyan BUA","E34000731","Total",388,185,203,388,0,4,24.25,16.0
"2011","Alnwick BUA","E34000732","Total",8116,3847,4269,7892,224,107,279.00,29.1
"2011","Bubwith BUA","E34000733","Total",954,480,474,954,0,13,39.25,24.3
"2011","Owslebury BUA","E34000734","Total",818,395,423,818,0,28,31.75,25.8
"2011","Exton (Rutland) BUA","E34000735","Total",607,295,312,585,22,13,24.00,25.3
"2011","Sutton St Nicholas BUA","E34000736","Total",925,444,481,925,0,22,45.00,20.6
"2011","Homer BUA","E34000737","Total",401,188,213,399,2,6,20.25,19.8
"2011","Sellindge BUA","E34000738","Total",759,366,393,759,0,9,39.75,19.1
"2011","Denshaw BUA","E34000739","Total",543,283,260,543,0,12,30.50,17.8
"2011","Scotter BUA","E34000740","Total",2865,1410,1455,2851,14,34,102.25,28.0
"2011","Billinge BUA","E34000741","Total",5896,2947,2949,5823,73,71,152.00,38.8
"2011","Walcott BUA","E34000742","Total",566,271,295,566,0,10,30.25,18.7
"2011","Dipley BUA","E34000743","Total",177,92,85,177,0,19,22.25,8.0
"2011","Delamere BUA","E34000744","Total",277,140,137,277,0,9,27.25,10.2
"2011","Cressage BUA","E34000745","Total",707,343,364,707,0,8,37.50,18.9
"2011","Detling BUA","E34000746","Total",658,337,321,655,3,12,33.25,19.8
"2011","Colaton Raleigh BUA","E34000747","Total",363,182,181,271,92,96,30.25,12.0
"2011","Red Lodge BUA","E34000748","Total",3834,1938,1896,3834,0,24,100.50,38.1
"2011","Ashton Keynes BUA","E34000749","Total",1400,668,732,1386,14,49,62.75,22.3
"2011","Cargreen BUA","E34000750","Total",224,112,112,224,0,5,25.00,9.0
"2011","Marshland St James BUA","E34000751","Total",853,414,439,804,49,4,81.75,10.4
"2011","Tealby BUA","E34000752","Total",593,286,307,593,0,20,49.00,12.1
"2011","Northchapel BUA","E34000753","Total",622,318,304,622,0,6,28.75,21.6
"2011","Holbrook BUA","E34000754","Total",1090,500,590,1090,0,31,67.00,16.3
"2011","Hailsham BUA","E34000755","Total",19977,9493,10484,19735,242,164,482.75,41.4
"2011","Hadstock BUA","E34000756","Total",332,168,164,332,0,15,24.75,13.4
"2011","Oving BUA","E34000757","Total",478,243,235,468,10,22,30.75,15.5
"2011","Widdrington Station BUA","E34000758","Total",2545,1226,1319,2522,23,28,69.75,36.5
"2011","Thorpe-le-Soken BUA","E34000759","Total",1394,694,700,1394,0,19,72.75,19.2
"2011","Covenham St Mary BUA","E34000760","Total",327,158,169,327,0,8,27.25,12.0
"2011","Church Stretton BUA","E34000761","Total",3698,1744,1954,3598,100,63,195.25,18.9
"2011","Richmond BUA","E34000762","Total",8413,4039,4374,8316,97,182,209.75,40.1
"2011","Lenham BUA","E34000763","Total",2197,1059,1138,2197,0,24,72.00,30.5
"2011","Loddon BUA","E34000764","Total",3552,1702,1850,3512,40,57,148.75,23.9
"2011","Leire BUA","E34000765","Total",587,306,281,587,0,17,31.25,18.8
"2011","Cheddar BUA","E34000766","Total",5199,2471,2728,5128,71,93,210.00,24.8
"2011","Longstock BUA","E34000767","Total",292,147,145,292,0,16,23.75,12.3
"2011","Oakley (Basingstoke and Deane) BUA","E34000768","Total",5086,2503,2583,5086,0,119,174.25,29.2
"2011","Chelmondiston BUA","E34000769","Total",938,457,481,938,0,20,47.25,19.9
"2011","Nunton BUA","E34000770","Total",229,103,126,229,0,15,23.75,9.6
"2011","Lechlade-on-Thames BUA","E34000771","Total",2507,1200,1307,2505,2,71,87.75,28.6
"2011","Palestine BUA","E34000772","Total",283,142,141,283,0,10,48.00,5.9
"2011","Hindolveston BUA","E34000773","Total",598,295,303,576,22,12,32.75,18.3
"2011","Alrewas BUA","E34000774","Total",2852,1361,1491,2852,0,63,84.50,33.8
"2011","Scholes BUA","E34000775","Total",2266,1099,1167,2259,7,28,64.00,35.4
"2011","Mablethorpe BUA","E34000776","Total",12531,5970,6561,12233,298,71,476.00,26.3
"2011","Eardiston BUA","E34000777","Total",324,156,168,324,0,6,26.25,12.3
"2011","Worminghall BUA","E34000778","Total",534,264,270,534,0,12,27.00,19.8
"2011","Thorrington (East) BUA","E34000779","Total",773,396,377,772,1,7,37.50,20.6
"2011","Tadmarton BUA","E34000780","Total",541,269,272,541,0,14,24.75,21.9
"2011","Horton Kirby BUA","E34000781","Total",1241,602,639,1206,35,16,50.00,24.8
"2011","Newton Solney BUA","E34000782","Total",659,311,348,579,80,13,31.50,20.9
"2011","Black Moor BUA","E34000783","Total",278,141,137,278,0,11,21.50,12.9
"2011","Swanton Abbott BUA","E34000784","Total",565,284,281,547,18,10,20.25,27.9
"2011","Leafield BUA","E34000785","Total",945,479,466,945,0,25,29.25,32.3
"2011","Lutterworth BUA","E34000786","Total",9907,4935,4972,9831,76,152,285.00,34.8
"2011","Langley Vale BUA","E34000787","Total",1470,725,745,1465,5,29,36.00,40.8
"2011","Trevone BUA","E34000788","Total",359,160,199,359,0,4,37.50,9.6
"2011","Long Marston (Stratford-on-Avon) BUA","E34000789","Total",436,221,215,436,0,17,21.25,20.5
"2011","Rainford Junction BUA","E34000790","Total",993,489,504,993,0,11,20.50,48.4
"2011","Croxdale BUA","E34000791","Total",505,260,245,505,0,6,23.75,21.3
"2011","Sawston BUA","E34000792","Total",7275,3593,3682,7236,39,109,211.50,34.4
"2011","Burneside BUA","E34000793","Total",1017,488,529,1017,0,22,39.00,26.1
"2011","Leek Wootton BUA","E34000794","Total",1017,501,516,1005,12,40,41.25,24.7
"2011","Norton (Mid Suffolk) BUA","E34000795","Total",575,289,286,575,0,20,38.50,14.9
"2011","Sidmouth BUA","E34000796","Total",12569,5725,6844,12211,358,167,497.75,25.3
"2011","Tattenhall BUA","E34000797","Total",1950,929,1021,1950,0,44,72.00,27.1
"2011","Yoxall BUA","E34000798","Total",1638,779,859,1638,0,31,61.25,26.7
"2011","Rippingale BUA","E34000799","Total",929,448,481,903,26,17,46.75,19.9
"2011","Lugwardine BUA","E34000800","Total",1913,978,935,1897,16,42,81.25,23.5
"2011","Bishop's Tawton BUA","E34000801","Total",782,387,395,782,0,9,43.50,18.0
"2011","Stathern BUA","E34000802","Total",728,352,376,728,0,12,33.25,21.9
"2011","Whiteway BUA","E34000803","Total",449,200,249,449,0,10,24.25,18.5
"2011","Doddington BUA","E34000804","Total",439,222,217,406,33,9,30.75,14.3
"2011","Swineshead BUA","E34000805","Total",2197,1083,1114,2197,0,23,93.75,23.4
"2011","Nafferton BUA","E34000806","Total",2433,1181,1252,2419,14,30,81.50,29.9
"2011","Middleham BUA","E34000807","Total",825,390,435,813,12,11,32.50,25.4
"2011","Sheepy Magna BUA","E34000808","Total",781,365,416,781,0,9,41.25,18.9
"2011","Fewcott BUA","E34000809","Total",751,353,398,725,26,8,35.00,21.5
"2011","Flushing BUA","E34000810","Total",722,343,379,722,0,4,35.25,20.5
"2011","Emley BUA","E34000811","Total",1497,734,763,1497,0,14,42.25,35.4
"2011","Mellor Brook BUA","E34000812","Total",2467,1167,1300,2465,2,43,223.75,11.0
"2011","Medomsley BUA","E34000813","Total",1283,623,660,1247,36,24,29.75,43.1
"2011","Dunster BUA","E34000814","Total",408,186,222,392,16,5,21.75,18.8
"2011","Epping BUA","E34000815","Total",10289,4914,5375,10178,111,128,292.75,35.1
"2011","Barford (Warwick) BUA","E34000816","Total",1336,651,685,1336,0,24,63.00,21.2
"2011","Haslingfield BUA","E34000817","Total",1507,758,749,1507,0,46,67.50,22.3
"2011","West Lulworth BUA","E34000818","Total",332,165,167,328,4,4,24.75,13.4
"2011","Harbury BUA","E34000819","Total",2148,1031,1117,2148,0,35,75.25,28.5
"2011","Misterton BUA","E34000820","Total",1862,924,938,1854,8,26,85.75,21.7
"2011","Weston (Cheshire East) BUA","E34000821","Total",847,416,431,847,0,5,33.50,25.3
"2011","Brookland BUA","E34000822","Total",479,236,243,479,0,12,25.50,18.8
"2011","Winterborne Stickland BUA","E34000823","Total",653,318,335,653,0,17,38.75,16.9
"2011","Souldern BUA","E34000824","Total",370,174,196,370,0,13,21.75,17.0
"2011","Lindholme BUA","E34000825","Total",2131,1945,186,349,1782,8,61.25,34.8
"2011","Rufford Country Park BUA","E34000826","Total",290,150,140,290,0,10,21.00,13.8
"2011","Cheriton Bishop BUA","E34000827","Total",652,341,311,648,4,21,26.00,25.1
"2011","Great Snoring BUA","E34000828","Total",143,75,68,143,0,3,21.00,6.8
"2011","Trimdon BUA","E34000829","Total",2958,1438,1520,2958,0,21,66.50,44.5
"2011","Torpoint BUA","E34000830","Total",7717,3715,4002,7695,22,74,210.75,36.6
"2011","Ewen BUA","E34000831","Total",257,125,132,257,0,4,23.50,10.9
"2011","Barford St Martin BUA","E34000832","Total",548,269,279,548,0,13,21.75,25.2
"2011","Bilsthorpe BUA","E34000833","Total",3514,1762,1752,3479,35,21,106.00,33.2
"2011","Buckhorn Weston BUA","E34000834","Total",356,175,181,353,3,5,20.50,17.4
"2011","Glatton BUA","E34000835","Total",308,154,154,292,16,6,33.50,9.2
"2011","Featherstone Prison BUA","E34000836","Total",1136,966,170,333,803,7,48.75,23.3
"2011","Royal Naval Air Station Yeovilton BUA","E34000837","Total",1226,993,233,320,906,12,231.75,5.3
"2011","Pett BUA","E34000838","Total",390,190,200,390,0,2,36.00,10.8
"2011","Hilton (South Derbyshire) BUA","E34000839","Total",7714,3852,3862,7714,0,88,160.25,48.1
"2011","Elmley Castle BUA","E34000840","Total",568,285,283,568,0,14,33.75,16.8
"2011","Hildenborough BUA","E34000841","Total",575,286,289,562,13,15,27.00,21.3
"2011","Pulham Market BUA","E34000842","Total",722,337,385,722,0,7,38.25,18.9
"2011","Burghfield Common BUA","E34000843","Total",5932,2916,3016,5870,62,102,166.75,35.6
"2011","Tittensor BUA","E34000844","Total",629,295,334,614,15,12,32.50,19.4
"2011","Great Crakehall BUA","E34000845","Total",677,334,343,675,2,14,28.25,24.0
"2011","Petrockstowe BUA","E34000846","Total",426,210,216,426,0,12,23.25,18.3
"2011","Watersfield BUA","E34000847","Total",344,171,173,344,0,14,29.50,11.7
"2011","Lavendon BUA","E34000848","Total",1303,636,667,1303,0,26,39.00,33.4
"2011","Newton St Faith BUA","E34000849","Total",485,246,239,485,0,2,28.00,17.3
"2011","Buckingham BUA","E34000850","Total",12890,6378,6512,12415,475,277,394.50,32.7
"2011","Nacton BUA","E34000851","Total",414,200,214,414,0,11,28.00,14.8
"2011","Netley BUA","E34000852","Total",6338,3068,3270,6248,90,51,149.25,42.5
"2011","Badingham BUA","E34000853","Total",220,106,114,220,0,5,22.50,9.8
"2011","Catfield BUA","E34000854","Total",699,357,342,681,18,6,41.50,16.8
"2011","Halton Holegate BUA","E34000855","Total",475,226,249,455,20,8,25.75,18.4
"2011","Heathfield (Teignbridge) BUA","E34000856","Total",1832,907,925,1832,0,17,88.50,20.7
"2011","Brackley BUA","E34000857","Total",13018,6476,6542,12872,146,231,352.50,36.9
"2011","Stratford St Mary BUA","E34000858","Total",701,342,359,701,0,16,35.50,19.7
"2011","Ulrome BUA","E34000859","Total",239,118,121,239,0,1,24.25,9.9
"2011","Blewbury BUA","E34000860","Total",1581,747,834,1581,0,41,77.00,20.5
"2011","South Heath BUA","E34000861","Total",825,419,406,825,0,32,35.75,23.1
"2011","Bigrigg BUA","E34000862","Total",706,335,371,706,0,7,22.50,31.4
"2011","Bomere Heath BUA","E34000863","Total",1254,609,645,1249,5,10,45.00,27.9
"2011","Chilthorne Domer BUA","E34000864","Total",574,293,281,574,0,10,21.25,27.0
"2011","Thornton BUA","E34000865","Total",991,481,510,991,0,15,33.50,29.6
"2011","Reighton BUA","E34000866","Total",407,199,208,407,0,6,20.25,20.1
"2011","Ivybridge BUA","E34000867","Total",11851,5716,6135,11703,148,220,275.25,43.1
"2011","Barrow (Ribble Valley) BUA","E34000868","Total",646,313,333,646,0,15,25.75,25.1
"2011","Lazonby BUA","E34000869","Total",787,382,405,787,0,20,41.25,19.1
"2011","Merriott BUA","E34000870","Total",1979,964,1015,1950,29,21,81.25,24.4
"2011","Tilton on the Hill BUA","E34000871","Total",371,182,189,371,0,6,25.00,14.8
"2011","Walpole St Peter BUA","E34000872","Total",1441,724,717,1441,0,16,138.25,10.4
"2011","Lower Kingswood BUA","E34000873","Total",1760,864,896,1754,6,26,69.25,25.4
"2011","Walton-on-Trent BUA","E34000874","Total",872,426,446,872,0,10,29.25,29.8
"2011","Great Bentley BUA","E34000875","Total",1545,767,778,1540,5,23,74.75,20.7
"2011","Biddulph Moor BUA","E34000876","Total",1640,829,811,1640,0,22,59.00,27.8
"2011","Cuddington (Aylesbury Vale) BUA","E34000877","Total",569,250,319,569,0,14,31.50,18.1
"2011","Bagworth BUA","E34000878","Total",1472,742,730,1472,0,8,46.25,31.8
"2011","Marske-by-the-Sea BUA","E34000879","Total",8282,3996,4286,8252,30,83,182.50,45.4
"2011","Tilshead BUA","E34000880","Total",358,177,181,342,16,10,24.75,14.5
"2011","Bradwell (Derbyshire Dales) BUA","E34000881","Total",1416,705,711,1412,4,20,61.75,22.9
"2011","Hampton Bishop BUA","E34000882","Total",339,160,179,304,35,6,20.50,16.5
"2011","Burstwick BUA","E34000883","Total",1924,951,973,1924,0,25,76.75,25.1
"2011","Denmead BUA","E34000884","Total",6107,2957,3150,6046,61,109,209.50,29.2
"2011","Paddock Wood BUA","E34000885","Total",7840,3845,3995,7830,10,103,204.50,38.3
"2011","Normanton on Trent BUA","E34000886","Total",345,180,165,345,0,5,24.50,14.1
"2011","Ulnes Walton BUA","E34000887","Total",262,130,132,262,0,5,44.75,5.9
"2011","Grundisburgh BUA","E34000888","Total",1375,657,718,1375,0,29,73.00,18.8
"2011","Findern BUA","E34000889","Total",1669,803,866,1653,16,25,41.75,40.0
"2011","Kirkby-le-Soken BUA","E34000890","Total",1387,675,712,1359,28,29,59.00,23.5
"2011","Garforth BUA","E34000891","Total",14838,7091,7747,14715,123,169,373.50,39.7
"2011","Chitterne BUA","E34000892","Total",307,157,150,307,0,9,30.75,10.0
"2011","Turnditch BUA","E34000893","Total",301,159,142,301,0,5,20.25,14.9
"2011","Ticehurst BUA","E34000894","Total",1705,815,890,1651,54,28,71.75,23.8
"2011","Coombe Bissett BUA","E34000895","Total",450,227,223,450,0,21,54.25,8.3
"2011","Shurdington BUA","E34000896","Total",1798,861,937,1770,28,27,71.50,25.1
"2011","Steeple Bumpstead BUA","E34000897","Total",1432,692,740,1432,0,32,50.50,28.4
"2011","Clarborough BUA","E34000898","Total",1281,638,643,1281,0,12,80.25,16.0
"2011","Kirkby Stephen BUA","E34000899","Total",1522,737,785,1516,6,21,69.25,22.0
"2011","Frosterley BUA","E34000900","Total",636,319,317,636,0,7,26.25,24.2
"2011","Nether Kellet BUA","E34000901","Total",663,315,348,663,0,3,28.50,23.3
"2011","Skirlaugh BUA","E34000902","Total",1473,716,757,1473,0,16,49.00,30.1
"2011","Debden BUA","E34000903","Total",328,163,165,328,0,7,27.25,12.0
"2011","Thorpeness BUA","E34000904","Total",231,109,122,231,0,5,34.75,6.6
"2011","Cottesmore Airfield BUA","E34000905","Total",995,563,432,829,166,30,196.25,5.1
"2011","Marshfield (South Gloucestershire) BUA","E34000906","Total",1441,715,726,1441,0,32,43.75,32.9
"2011","Kirmington BUA","E34000907","Total",365,172,193,365,0,4,28.75,12.7
"2011","Kniveton BUA","E34000908","Total",392,198,194,392,0,11,22.75,17.2
"2011","Kelbrook BUA","E34000909","Total",678,341,337,677,1,11,20.50,33.1
"2011","Fenny Compton BUA","E34000910","Total",808,397,411,808,0,10,35.75,22.6
"2011","Flexford BUA","E34000911","Total",1598,788,810,1592,6,44,100.00,16.0
"2011","Knebworth BUA","E34000912","Total",4155,2038,2117,4114,41,84,131.00,31.7
"2011","Honingham BUA","E34000913","Total",358,180,178,358,0,10,23.75,15.1
"2011","Thorverton BUA","E34000914","Total",674,325,349,671,3,10,27.00,25.0
"2011","South Kilworth BUA","E34000915","Total",513,246,267,513,0,17,20.25,25.3
"2011","Goodleigh BUA","E34000916","Total",450,238,212,425,25,15,27.00,16.7
"2011","Tickhill BUA","E34000917","Total",4992,2352,2640,4992,0,77,165.50,30.2
"2011","Compton (West Berkshire) BUA","E34000918","Total",1571,816,755,1557,14,34,65.50,24.0
"2011","Moulton Chapel BUA","E34000919","Total",1050,513,537,1050,0,16,32.00,32.8
"2011","Cropthorne BUA","E34000920","Total",619,303,316,617,2,13,42.75,14.5
"2011","Little Milton BUA","E34000921","Total",486,232,254,486,0,24,25.50,19.1
"2011","Northallerton BUA","E34000922","Total",16832,8185,8647,16493,339,233,497.50,33.8
"2011","Easington (Redcar and Cleveland) BUA","E34000923","Total",923,461,462,923,0,8,29.50,31.3
"2011","Barking BUA","E34000924","Total",446,216,230,403,43,13,30.75,14.5
"2011","Hare Green BUA","E34000925","Total",664,338,326,659,5,12,23.75,28.0
"2011","Tenterden BUA","E34000926","Total",7118,3293,3825,7020,98,92,265.75,26.8
"2011","Borrowby BUA","E34000927","Total",386,192,194,386,0,8,23.75,16.3
"2011","Steep BUA","E34000928","Total",849,387,462,510,339,34,52.50,16.2
"2011","Rufford BUA","E34000929","Total",1420,703,717,1389,31,30,57.00,24.9
"2011","Chittlehampton BUA","E34000930","Total",239,113,126,239,0,5,21.75,11.0
"2011","Ackleton BUA","E34000931","Total",307,148,159,307,0,4,21.75,14.1
"2011","Dunton BUA","E34000932","Total",696,351,345,696,0,18,22.75,30.6
"2011","Woodgreen BUA","E34000933","Total",489,236,253,489,0,15,55.00,8.9
"2011","Upton Snodsbury BUA","E34000934","Total",385,182,203,385,0,7,24.75,15.6
"2011","Market Warsop BUA","E34000935","Total",9018,4399,4619,8925,93,67,219.25,41.1
"2011","Bix BUA","E34000936","Total",263,127,136,263,0,9,24.00,11.0
"2011","Edgmond BUA","E34000937","Total",1080,536,544,1080,0,20,52.50,20.6
"2011","Culmstock BUA","E34000938","Total",554,262,292,554,0,9,29.00,19.1
"2011","Quinton BUA","E34000939","Total",204,96,108,204,0,6,22.00,9.3
"2011","Stithians BUA","E34000940","Total",1463,730,733,1463,0,28,43.00,34.0
"2011","Elmstead Market BUA","E34000941","Total",1646,799,847,1632,14,21,51.00,32.3
"2011","High Ham BUA","E34000942","Total",398,176,222,398,0,12,38.25,10.4
"2011","West Haddon BUA","E34000943","Total",1718,813,905,1679,39,40,47.75,36.0
"2011","Escrick BUA","E34000944","Total",944,367,577,775,169,23,48.75,19.4
"2011","Goodworth Clatford BUA","E34000945","Total",573,278,295,573,0,14,44.50,12.9
"2011","Dishforth BUA","E34000946","Total",382,192,190,382,0,4,24.50,15.6
"2011","Linton-on-Ouse BUA","E34000947","Total",1008,570,438,843,165,10,146.25,6.9
"2011","Crapstone BUA","E34000948","Total",667,308,359,667,0,19,41.00,16.3
"2011","Egmanton BUA","E34000949","Total",286,149,137,274,12,11,26.25,10.9
"2011","Wyre Piddle BUA","E34000950","Total",617,303,314,617,0,14,25.50,24.2
"2011","Gosfield BUA","E34000951","Total",1140,552,588,1124,16,10,55.00,20.7
"2011","Harlington BUA","E34000952","Total",2297,1149,1148,2297,0,55,68.50,33.5
"2011","Langho BUA","E34000953","Total",2015,997,1018,2015,0,41,69.75,28.9
"2011","Clyst St Mary BUA","E34000954","Total",849,425,424,849,0,27,41.25,20.6
"2011","Methley BUA","E34000955","Total",1184,588,596,1184,0,13,20.75,57.1
"2011","Severn Beach BUA","E34000956","Total",2182,1117,1065,2174,8,7,52.00,42.0
"2011","Castle Acre BUA","E34000957","Total",848,420,428,847,1,12,49.25,17.2
"2011","Cotton End BUA","E34000958","Total",838,398,440,838,0,4,24.50,34.2
"2011","Chalgrove BUA","E34000959","Total",2830,1420,1410,2830,0,33,100.75,28.1
"2011","Barham BUA","E34000960","Total",1114,527,587,1069,45,22,58.25,19.1
"2011","Coleford (Mendip) BUA","E34000961","Total",2151,1064,1087,2151,0,29,66.75,32.2
"2011","Nettleham BUA","E34000962","Total",3437,1616,1821,3437,0,61,131.00,26.2
"2011","Litlington BUA","E34000963","Total",877,429,448,877,0,22,39.00,22.5
"2011","Kingsdown (Dover) BUA","E34000964","Total",1729,828,901,1688,41,29,78.75,22.0
"2011","The Thorne BUA","E34000965","Total",509,244,265,509,0,8,28.75,17.7
"2011","Manton BUA","E34000966","Total",359,161,198,324,35,10,23.25,15.4
"2011","Watton at Stone BUA","E34000967","Total",2338,1137,1201,2328,10,34,67.50,34.6
"2011","Nettleton BUA","E34000968","Total",685,338,347,656,29,15,44.25,15.5
"2011","Tadcaster BUA","E34000969","Total",6480,3177,3303,6471,9,110,199.50,32.5
"2011","Long Ashton BUA","E34000970","Total",5254,2567,2687,5224,30,102,147.25,35.7
"2011","Hope (High Peak) BUA","E34000971","Total",864,415,449,864,0,15,39.00,22.2
"2011","Bruton BUA","E34000972","Total",2984,1454,1530,2483,501,106,110.00,27.1
"2011","Burghclere Common BUA","E34000973","Total",322,153,169,322,0,21,31.75,10.1
"2011","Longwick BUA","E34000974","Total",1143,571,572,1132,11,14,49.50,23.1
"2011","Buriton BUA","E34000975","Total",507,264,243,507,0,11,26.75,19.0
"2011","Snape (Suffolk Coastal) BUA","E34000976","Total",295,140,155,295,0,4,33.75,8.7
"2011","Epworth BUA","E34000977","Total",4279,2070,2209,4275,4,67,158.50,27.0
"2011","Withern BUA","E34000978","Total",380,186,194,351,29,4,24.75,15.4
"2011","Warboys BUA","E34000979","Total",3825,1891,1934,3825,0,66,108.50,35.3
"2011","Hayle BUA","E34000980","Total",8210,3929,4281,8032,178,69,239.00,34.4
"2011","Bramfield BUA","E34000981","Total",487,268,219,444,43,7,25.75,18.9
"2011","Betsham BUA","E34000982","Total",409,209,200,409,0,7,21.00,19.5
"2011","Ashton Hayes BUA","E34000983","Total",936,452,484,936,0,9,36.00,26.0
"2011","Seend Cleeve BUA","E34000984","Total",593,286,307,593,0,11,26.75,22.2
"2011","Stannington BUA","E34000985","Total",427,215,212,427,0,3,23.75,18.0
"2011","Dalston BUA","E34000986","Total",1285,607,678,1285,0,17,58.25,22.1
"2011","Little Paxton BUA","E34000987","Total",3244,1608,1636,3212,32,44,92.00,35.3
"2011","South Milford BUA","E34000988","Total",1995,967,1028,1995,0,20,66.50,30.0
"2011","Beaminster BUA","E34000989","Total",2957,1383,1574,2948,9,35,131.75,22.4
"2011","Rolvenden BUA","E34000990","Total",691,323,368,691,0,14,30.50,22.7
"2011","Conisbrough BUA","E34000991","Total",15934,7728,8206,15783,151,75,386.00,41.3
"2011","Wool BUA","E34000992","Total",2724,1312,1412,2724,0,26,103.00,26.4
"2011","Sutton Benger BUA","E34000993","Total",1045,512,533,1045,0,28,39.75,26.3
"2011","Nantwich BUA","E34000994","Total",17226,8312,8914,16988,238,183,425.75,40.5
"2011","Brabourne Lees BUA","E34000995","Total",1463,700,763,1463,0,30,67.00,21.8
"2011","Skeffling BUA","E34000996","Total",149,72,77,149,0,1,20.75,7.2
"2011","Ingham (West Lindsey) BUA","E34000997","Total",912,430,482,903,9,17,39.25,23.2
"2011","Heckfield Green BUA","E34000998","Total",613,305,308,586,27,9,33.75,18.2
"2011","Capel-le-Ferne BUA","E34000999","Total",1386,675,711,1382,4,13,57.75,24.0
"2011","Meden Vale BUA","E34001000","Total",2228,1101,1127,2228,0,7,55.50,40.1
"2011","Hovingham BUA","E34001001","Total",362,166,196,359,3,15,23.25,15.6
"2011","Clifton (Eden) BUA","E34001002","Total",497,254,243,493,4,7,22.00,22.6
"2011","Grindleton BUA","E34001003","Total",435,215,220,435,0,16,20.75,21.0
"2011","Loders BUA","E34001004","Total",276,132,144,276,0,1,20.50,13.5
"2011","Beare Green BUA","E34001005","Total",455,233,222,454,1,7,49.75,9.1
"2011","Howden BUA","E34001006","Total",4142,2066,2076,4112,30,40,178.00,23.3
"2011","Child Okeford BUA","E34001007","Total",1114,536,578,1088,26,38,72.50,15.4
"2011","Goodmanham BUA","E34001008","Total",244,121,123,244,0,2,25.50,9.6
"2011","Marchington BUA","E34001009","Total",615,294,321,615,0,14,64.00,9.6
"2011","St Agnes BUA","E34001010","Total",2860,1337,1523,2860,0,45,143.25,20.0
"2011","Painswick BUA","E34001011","Total",1762,820,942,1761,1,41,101.75,17.3
"2011","Mevagissey BUA","E34001012","Total",2117,995,1122,2071,46,13,92.00,23.0
"2011","Brampford Speke BUA","E34001013","Total",419,207,212,419,0,4,29.75,14.1
"2011","Charlton-on-Otmoor BUA","E34001014","Total",449,227,222,449,0,3,21.50,20.9
"2011","Magham Down BUA","E34001015","Total",283,142,141,279,4,3,24.25,11.7
"2011","Messingham BUA","E34001016","Total",3496,1684,1812,3496,0,67,103.00,33.9
"2011","Slinfold BUA","E34001017","Total",1147,559,588,1134,13,19,57.75,19.9
"2011","Great Witley BUA","E34001018","Total",560,269,291,550,10,16,32.00,17.5
"2011","Wiswell BUA","E34001019","Total",321,156,165,321,0,14,21.25,15.1
"2011","Sutton upon Derwent BUA","E34001020","Total",594,292,302,594,0,15,29.50,20.1
"2011","Blackwater BUA","E34001021","Total",616,307,309,616,0,6,22.00,28.0
"2011","Nomansland BUA","E34001022","Total",1128,560,568,1128,0,15,76.50,14.7
"2011","Northgate BUA","E34001023","Total",651,305,346,651,0,7,28.50,22.8
"2011","Market Drayton BUA","E34001024","Total",11773,5750,6023,11692,81,117,351.25,33.5
"2011","Cheswardine BUA","E34001025","Total",716,356,360,684,32,14,25.50,28.1
"2011","Cawood BUA","E34001026","Total",1409,689,720,1409,0,20,65.25,21.6
"2011","West Keal BUA","E34001027","Total",327,152,175,318,9,5,20.75,15.8
"2011","Bradenham BUA","E34001028","Total",387,192,195,387,0,2,26.50,14.6
"2011","Hapton BUA","E34001029","Total",1979,1001,978,1939,40,25,51.50,38.4
"2011","Pyrton BUA","E34001030","Total",227,110,117,227,0,9,21.00,10.8
"2011","Backbarrow BUA","E34001031","Total",512,267,245,512,0,10,23.75,21.6
"2011","Occold BUA","E34001032","Total",519,261,258,519,0,16,24.75,21.0
"2011","Crockham Hill BUA","E34001033","Total",291,143,148,291,0,13,26.00,11.2
"2011","Over BUA","E34001034","Total",2862,1411,1451,2862,0,60,109.75,26.1
"2011","Warnham BUA","E34001035","Total",1193,562,631,1193,0,21,46.50,25.7
"2011","Gaydon BUA","E34001036","Total",446,233,213,441,5,16,26.25,17.0
"2011","Wacton BUA","E34001037","Total",302,149,153,302,0,1,21.50,14.0
"2011","Green Hammerton BUA","E34001038","Total",675,344,331,668,7,14,37.25,18.1
"2011","Portishead BUA","E34001039","Total",23699,11631,12068,23574,125,315,613.50,38.6
"2011","South Newton BUA","E34001040","Total",462,257,205,338,124,7,26.50,17.4
"2011","Barnby BUA","E34001041","Total",928,447,481,928,0,7,48.75,19.0
"2011","Alne BUA","E34001042","Total",569,260,309,513,56,19,28.25,20.1
"2011","Upper Broughton BUA","E34001043","Total",327,165,162,327,0,7,22.75,14.4
"2011","Pewsey BUA","E34001044","Total",3634,1733,1901,3586,48,57,132.50,27.4
"2011","Rock (Horsham) BUA","E34001045","Total",265,116,149,265,0,4,21.50,12.3
"2011","Braunston BUA","E34001046","Total",1513,736,777,1513,0,20,48.25,31.4
"2011","Weir BUA","E34001047","Total",1251,634,617,1227,24,25,30.50,41.0
"2011","Little London BUA","E34001048","Total",361,191,170,361,0,16,21.25,17.0
"2011","Watlington (King's Lynn and West Norfolk) BUA","E34001049","Total",2455,1182,1273,2455,0,21,86.00,28.5
"2011","Crofton BUA","E34001050","Total",5258,2593,2665,5258,0,46,123.75,42.5
"2011","Corfe Castle BUA","E34001051","Total",1355,664,691,1345,10,36,54.75,24.7
"2011","Wotton-under-Edge BUA","E34001052","Total",5627,2751,2876,5566,61,122,151.75,37.1
"2011","Chelworth Lower Green BUA","E34001053","Total",197,105,92,195,2,4,27.50,7.2
"2011","Surlingham BUA","E34001054","Total",542,275,267,527,15,10,33.75,16.1
"2011","Crudwell BUA","E34001055","Total",630,319,311,630,0,23,42.75,14.7
"2011","Stebbing BUA","E34001056","Total",923,448,475,923,0,21,41.25,22.4
"2011","Hambleton (Wyre) BUA","E34001057","Total",2247,1082,1165,2157,90,21,71.25,31.5
"2011","Trent BUA","E34001058","Total",317,152,165,317,0,9,21.75,14.6
"2011","Sibsey BUA","E34001059","Total",1464,712,752,1464,0,30,66.00,22.2
"2011","Ebrington BUA","E34001060","Total",304,148,156,304,0,8,20.25,15.0
"2011","Pateley Bridge BUA","E34001061","Total",1432,677,755,1415,17,11,66.50,21.5
"2011","Ramsey Mereside BUA","E34001062","Total",686,349,337,686,0,11,22.25,30.8
"2011","Ashley (Kettering) BUA","E34001063","Total",224,104,120,224,0,8,22.00,10.2
"2011","Marple BUA","E34001064","Total",18241,8738,9503,17954,287,280,569.00,32.1
"2011","Thurleigh BUA","E34001065","Total",694,343,351,684,10,13,22.00,31.5
"2011","Southwell BUA","E34001066","Total",6757,3221,3536,6696,61,177,239.25,28.2
"2011","Dawlish BUA","E34001067","Total",11312,5301,6011,11019,293,115,309.75,36.5
"2011","Dronfield BUA","E34001068","Total",21124,10268,10856,20984,140,267,612.50,34.5
"2011","Frettenham BUA","E34001069","Total",592,288,304,589,3,7,27.25,21.7
"2011","Wootton Bassett BUA","E34001070","Total",11265,5523,5742,11148,117,221,282.75,39.8
"2011","Newton (Rushcliffe) BUA","E34001071","Total",391,188,203,391,0,9,43.25,9.0
"2011","Cotherstone BUA","E34001072","Total",594,286,308,594,0,13,26.75,22.2
"2011","Hawkinge BUA","E34001073","Total",8002,3934,4068,7985,17,90,171.50,46.7
"2011","East Worldham BUA","E34001074","Total",354,175,179,354,0,15,21.50,16.5
"2011","Evercreech BUA","E34001075","Total",1845,881,964,1795,50,24,66.50,27.7
"2011","Swaton BUA","E34001076","Total",201,93,108,201,0,4,21.25,9.5
"2011","Weston under Penyard BUA","E34001077","Total",670,324,346,670,0,11,22.50,29.8
"2011","Syresham BUA","E34001078","Total",711,340,371,711,0,11,37.75,18.8
"2011","Paulerspury BUA","E34001079","Total",644,313,331,644,0,18,39.75,16.2
"2011","Down Ampney BUA","E34001080","Total",644,334,310,644,0,13,28.25,22.8
"2011","Askham Bryan BUA","E34001081","Total",564,288,276,394,170,24,26.00,21.7
"2011","Beckingham BUA","E34001082","Total",1098,548,550,1098,0,24,59.75,18.4
"2011","Burnham Market BUA","E34001083","Total",877,406,471,877,0,17,75.50,11.6
"2011","Finedon BUA","E34001084","Total",4309,2153,2156,4302,7,38,109.00,39.5
"2011","Kingston (North Dorset) BUA","E34001085","Total",614,310,304,614,0,12,30.50,20.1
"2011","Coniston BUA","E34001086","Total",641,322,319,629,12,14,33.25,19.3
"2011","Lower Common BUA","E34001087","Total",388,188,200,388,0,17,38.00,10.2
"2011","Hockwold cum Wilton BUA","E34001088","Total",1195,583,612,1195,0,12,61.50,19.4
"2011","Halam BUA","E34001089","Total",426,205,221,426,0,19,31.25,13.6
"2011","Edgcott BUA","E34001090","Total",988,758,230,476,512,11,23.50,42.0
"2011","Coney Weston BUA","E34001091","Total",394,195,199,394,0,5,29.75,13.2
"2011","Storth BUA","E34001092","Total",978,466,512,976,2,14,67.25,14.5
"2011","Bescar BUA","E34001093","Total",571,276,295,571,0,2,25.25,22.6
"2011","Duddon BUA","E34001094","Total",655,320,335,655,0,12,28.50,23.0
"2011","Feckenham BUA","E34001095","Total",364,183,181,364,0,10,26.00,14.0
"2011","Holloway BUA","E34001096","Total",508,237,271,508,0,19,29.00,17.5
"2011","Shiptonthorpe BUA","E34001097","Total",503,255,248,503,0,7,31.00,16.2
"2011","Radway BUA","E34001098","Total",238,106,132,238,0,5,30.50,7.8
"2011","Alfriston BUA","E34001099","Total",829,371,458,786,43,9,41.00,20.2
"2011","Kingston (South Cambridgeshire) BUA","E34001100","Total",238,120,118,238,0,8,23.50,10.1
"2011","Peterchurch BUA","E34001101","Total",732,355,377,732,0,8,32.50,22.5
"2011","Peasedown St John BUA","E34001102","Total",6269,3102,3167,6265,4,75,146.75,42.7
"2011","Folksworth BUA","E34001103","Total",881,428,453,881,0,23,32.75,26.9
"2011","Sherburn (County Durham) BUA","E34001104","Total",3140,1554,1586,3140,0,19,72.75,43.2
"2011","Plaxtol BUA","E34001105","Total",606,314,292,601,5,16,48.25,12.6
"2011","Ebchester BUA","E34001106","Total",871,430,441,850,21,2,33.50,26.0
"2011","Stone (Stroud) BUA","E34001107","Total",469,240,229,469,0,9,28.50,16.5
"2011","New Waltham BUA","E34001108","Total",5613,2738,2875,5559,54,89,191.50,29.3
"2011","Five Ashes BUA","E34001109","Total",507,252,255,507,0,10,35.00,14.5
"2011","Great Ouseburn BUA","E34001110","Total",598,282,316,598,0,24,28.75,20.8
"2011","Abbotskerswell BUA","E34001111","Total",1267,594,673,1241,26,12,50.25,25.2
"2011","Seamer (Hambleton) BUA","E34001112","Total",303,140,163,303,0,7,25.00,12.1
"2011","Fiskerton (West Lindsey) BUA","E34001113","Total",1209,583,626,1099,110,4,43.75,27.6
"2011","Swinford BUA","E34001114","Total",586,306,280,586,0,17,22.50,26.0
"2011","Thornton-le-Dale BUA","E34001115","Total",1759,819,940,1724,35,26,89.00,19.8
"2011","Swimbridge BUA","E34001116","Total",669,322,347,647,22,6,29.25,22.9
"2011","Dinnington (Rotherham) BUA","E34001117","Total",19860,9772,10088,19723,137,216,585.75,33.9
"2011","Billesdon BUA","E34001118","Total",901,426,475,901,0,23,38.25,23.6
"2011","Stansted Mountfitchet BUA","E34001119","Total",6669,3346,3323,6594,75,108,178.50,37.4
"2011","Brasted BUA","E34001120","Total",844,406,438,844,0,17,46.75,18.1
"2011","Barnwell BUA","E34001121","Total",369,172,197,369,0,17,25.50,14.5
"2011","Woodplumpton BUA","E34001122","Total",688,333,355,669,19,15,23.75,29.0
"2011","Priors Hardwick BUA","E34001123","Total",172,78,94,172,0,4,31.25,5.5
"2011","Wychbold BUA","E34001124","Total",1366,666,700,1314,52,9,36.75,37.2
"2011","Arlecdon BUA","E34001125","Total",757,358,399,757,0,5,31.75,23.8
"2011","Balsall Common BUA","E34001126","Total",7039,3458,3581,7039,0,193,217.75,32.3
"2011","Lound BUA","E34001127","Total",471,220,251,451,20,15,33.00,14.3
"2011","Hightown BUA","E34001128","Total",2063,1016,1047,2063,0,47,76.50,27.0
"2011","Bayston Hill BUA","E34001129","Total",5079,2488,2591,5020,59,100,132.00,38.5
"2011","Hatch Beauchamp BUA","E34001130","Total",317,145,172,294,23,5,40.50,7.8
"2011","Broughton (Preston) BUA","E34001131","Total",1487,719,768,1487,0,29,77.25,19.2
"2011","Birch Green BUA","E34001132","Total",859,428,431,859,0,19,44.75,19.2
"2011","Rowney Green BUA","E34001133","Total",289,141,148,289,0,6,34.50,8.4
"2011","High Beach BUA","E34001134","Total",275,134,141,275,0,8,22.25,12.4
"2011","Fremington BUA","E34001135","Total",4310,2020,2290,4248,62,52,157.75,27.3
"2011","Stowbridge BUA","E34001136","Total",386,192,194,386,0,6,21.25,18.2
"2011","Windmill Hill BUA","E34001137","Total",641,298,343,641,0,9,53.75,11.9
"2011","Thorp Arch BUA","E34001138","Total",1505,1148,357,692,813,14,151.00,10.0
"2011","Hinton St George BUA","E34001139","Total",442,207,235,442,0,6,26.00,17.0
"2011","Shillingstone BUA","E34001140","Total",1170,572,598,1114,56,27,56.25,20.8
"2011","Butterwick BUA","E34001141","Total",1302,646,656,1302,0,18,46.50,28.0
"2011","Bedfield Long Green BUA","E34001142","Total",324,152,172,324,0,7,29.00,11.2
"2011","Whittington (Lichfield) BUA","E34001143","Total",2063,1015,1048,2063,0,41,64.50,32.0
"2011","Badby BUA","E34001144","Total",632,312,320,595,37,15,32.50,19.4
"2011","North Hayling BUA","E34001145","Total",439,228,211,439,0,8,31.25,14.0
"2011","Cromwell BUA","E34001146","Total",232,114,118,232,0,7,21.75,10.7
"2011","North Cowton BUA","E34001147","Total",503,253,250,502,1,14,20.25,24.8
"2011","All Stretton BUA","E34001148","Total",308,146,162,290,18,4,25.25,12.2
"2011","Lustleigh BUA","E34001149","Total",285,143,142,285,0,12,41.00,7.0
"2011","Shripney BUA","E34001150","Total",345,173,172,345,0,8,25.75,13.4
"2011","Queen Camel BUA","E34001151","Total",574,271,303,574,0,12,30.50,18.8
"2011","Westhead BUA","E34001152","Total",795,397,398,791,4,9,20.25,39.3
"2011","Beetley BUA","E34001153","Total",964,469,495,964,0,11,53.75,17.9
"2011","Eyam BUA","E34001154","Total",969,462,507,969,0,22,42.25,22.9
"2011","Embsay BUA","E34001155","Total",1679,796,883,1679,0,36,52.75,31.8
"2011","Cheddleton BUA","E34001156","Total",2947,1448,1499,2883,64,24,113.75,25.9
"2011","Caldbeck BUA","E34001157","Total",311,151,160,309,2,10,22.75,13.7
"2011","Bishop's Tachbrook BUA","E34001158","Total",1787,896,891,1779,8,25,44.50,40.2
"2011","Upton (Newark and Sherwood) BUA","E34001159","Total",425,209,216,409,16,16,30.75,13.8
"2011","Northampton (South Northamptonshire) BUA","E34001160","Total",4404,2193,2211,4342,62,57,100.00,44.0
"2011","Somerford Keynes BUA","E34001161","Total",479,235,244,479,0,16,25.75,18.6
"2011","Norley BUA","E34001162","Total",634,304,330,609,25,30,39.50,16.1
"2011","Acaster Malbis BUA","E34001163","Total",280,139,141,275,5,4,22.25,12.6
"2011","Stalmine BUA","E34001164","Total",1087,540,547,1085,2,17,43.75,24.8
"2011","Whitchurch (Aylesbury Vale) BUA","E34001165","Total",932,458,474,932,0,23,52.25,17.8
"2011","Upton Cheyney BUA","E34001166","Total",450,214,236,450,0,8,27.00,16.7
"2011","Tytherleigh BUA","E34001167","Total",254,122,132,254,0,5,26.25,9.7
"2011","Denham Green BUA","E34001168","Total",2939,1379,1560,2861,78,40,161.75,18.2
"2011","Arlington BUA","E34001169","Total",627,308,319,619,8,12,33.25,18.9
"2011","Hoveton BUA","E34001170","Total",3089,1466,1623,2991,98,26,218.25,14.2
"2011","High Legh BUA","E34001171","Total",1145,552,593,1145,0,31,45.25,25.3
"2011","Hargrave BUA","E34001172","Total",241,111,130,241,0,3,20.75,11.6
"2011","Crews Hill BUA","E34001173","Total",566,280,286,566,0,4,79.50,7.1
"2011","Poulton BUA","E34001174","Total",408,200,208,408,0,20,26.50,15.4
"2011","Swan Green BUA","E34001175","Total",415,200,215,415,0,8,28.00,14.8
"2011","Steeple BUA","E34001176","Total",490,243,247,489,1,4,24.50,20.0
"2011","Stokeinteignhead BUA","E34001177","Total",354,178,176,354,0,12,20.25,17.5
"2011","Woodnewton BUA","E34001178","Total",450,232,218,450,0,12,27.25,16.5
"2011","Smallfield BUA","E34001179","Total",3769,1848,1921,3754,15,46,156.25,24.1
"2011","Weedon Bec BUA","E34001180","Total",2706,1316,1390,2706,0,39,103.50,26.1
"2011","Bulkington BUA","E34001181","Total",285,134,151,285,0,7,21.50,13.3
"2011","Oakley (Bedford) BUA","E34001182","Total",2493,1221,1272,2487,6,52,85.75,29.1
"2011","Woodham Mortimer BUA","E34001183","Total",641,316,325,641,0,23,62.25,10.3
"2011","Rookery Hill BUA","E34001184","Total",987,480,507,987,0,6,39.25,25.1
"2011","Bothel BUA","E34001185","Total",483,227,256,483,0,7,23.25,20.8
"2011","Irchester BUA","E34001186","Total",4419,2189,2230,4334,85,41,99.00,44.6
"2011","Lacey Green BUA","E34001187","Total",1147,569,578,1147,0,29,74.50,15.4
"2011","Little Staughton BUA","E34001188","Total",440,225,215,440,0,17,27.50,16.0
"2011","Blackford BUA","E34001189","Total",736,381,355,736,0,22,28.25,26.1
"2011","Amotherby BUA","E34001190","Total",399,200,199,399,0,9,29.00,13.8
"2011","Blakedown BUA","E34001191","Total",1588,776,812,1575,13,25,100.50,15.8
"2011","Colton (Lichfield) BUA","E34001192","Total",671,334,337,668,3,18,27.25,24.6
"2011","Breachwood Green BUA","E34001193","Total",693,353,340,693,0,8,25.25,27.4
"2011","North Crawley BUA","E34001194","Total",736,360,376,736,0,9,22.75,32.4
"2011","Dennington BUA","E34001195","Total",289,130,159,289,0,5,22.25,13.0
"2011","Bramham BUA","E34001196","Total",1650,782,868,1650,0,47,48.00,34.4
"2011","Long Hanborough BUA","E34001197","Total",2401,1167,1234,2401,0,53,76.50,31.4
"2011","Tydd St Giles BUA","E34001198","Total",652,322,330,652,0,10,57.25,11.4
"2011","Hainford BUA","E34001199","Total",422,205,217,422,0,6,43.50,9.7
"2011","Foxton (Harborough) BUA","E34001200","Total",478,236,242,478,0,9,31.50,15.2
"2011","Reepham BUA","E34001201","Total",2319,1106,1213,2319,0,43,100.00,23.2
"2011","Faringdon BUA","E34001202","Total",7121,3468,3653,7034,87,118,158.00,45.1
"2011","Ashton (Cornwall) BUA","E34001203","Total",559,277,282,559,0,9,27.75,20.1
"2011","Medburn BUA","E34001204","Total",121,56,65,121,0,3,20.75,5.8
"2011","Lea BUA","E34001205","Total",553,278,275,553,0,10,36.00,15.4
"2011","Marton (West Lindsey) BUA","E34001206","Total",747,362,385,710,37,11,32.75,22.8
"2011","Thorner BUA","E34001207","Total",1408,678,730,1408,0,30,55.00,25.6
"2011","Lewknor BUA","E34001208","Total",322,160,162,322,0,10,22.00,14.6
"2011","Strete BUA","E34001209","Total",474,229,245,474,0,7,34.00,13.9
"2011","West Wittering BUA","E34001210","Total",875,398,477,871,4,34,63.50,13.8
"2011","Graffham BUA","E34001211","Total",516,245,271,514,2,29,50.25,10.3
"2011","Upwood BUA","E34001212","Total",390,197,193,390,0,9,28.50,13.7
"2011","Hornick BUA","E34001213","Total",324,161,163,318,6,2,36.75,8.8
"2011","Weaverham BUA","E34001214","Total",6087,2957,3130,6057,30,66,160.00,38.0
"2011","Garton-on-the-Wolds BUA","E34001215","Total",348,168,180,348,0,4,21.25,16.4
"2011","Howden-le-Wear BUA","E34001216","Total",1535,779,756,1535,0,7,36.25,42.3
"2011","Glapthorn BUA","E34001217","Total",271,133,138,271,0,10,23.25,11.7
"2011","Preston (Dover) BUA","E34001218","Total",674,336,338,674,0,25,27.75,24.3
"2011","Carleton-in-Craven BUA","E34001219","Total",1118,547,571,1102,16,26,27.25,41.0
"2011","Priors Marston BUA","E34001220","Total",579,290,289,579,0,18,38.25,15.1
"2011","Langley Park BUA","E34001221","Total",4545,2160,2385,4433,112,35,88.25,51.5
"2011","Temple Sowerby BUA","E34001222","Total",528,265,263,525,3,9,22.25,23.7
"2011","Penwood BUA","E34001223","Total",610,295,315,610,0,18,20.75,29.4
"2011","Hayton (Carlisle) BUA","E34001224","Total",598,304,294,598,0,21,21.75,27.5
"2011","Stanwick BUA","E34001225","Total",1942,961,981,1905,37,34,57.75,33.6
"2011","Merrybent BUA","E34001226","Total",490,246,244,490,0,5,22.50,21.8
"2011","North Petherton BUA","E34001227","Total",3142,1522,1620,3125,17,37,94.50,33.2
"2011","Middlezoy BUA","E34001228","Total",725,361,364,725,0,12,29.75,24.4
"2011","West Quantoxhead BUA","E34001229","Total",343,178,165,343,0,9,25.50,13.5
"2011","Hunston BUA","E34001230","Total",1257,616,641,1245,12,14,30.75,40.9
"2011","Happisburgh BUA","E34001231","Total",380,174,206,380,0,2,24.25,15.7
"2011","Ilminster BUA","E34001232","Total",5808,2792,3016,5735,73,57,157.50,36.9
"2011","Ferryhill BUA","E34001233","Total",9805,4790,5015,9734,71,52,201.50,48.7
"2011","Buxton (Broadland) BUA","E34001234","Total",1316,654,662,1280,36,9,77.00,17.1
"2011","Chandler's Cross BUA","E34001235","Total",330,165,165,330,0,11,20.25,16.3
"2011","Gisburn BUA","E34001236","Total",521,266,255,500,21,10,25.25,20.6
"2011","North Molton BUA","E34001237","Total",721,350,371,721,0,3,36.00,20.0
"2011","Bethersden BUA","E34001238","Total",876,425,451,865,11,11,50.00,17.5
"2011","Crowlas BUA","E34001239","Total",941,462,479,941,0,18,34.50,27.3
"2011","Kirk Merrington BUA","E34001240","Total",799,406,393,799,0,5,24.50,32.6
"2011","Monk Fryston BUA","E34001241","Total",1728,862,866,1721,7,39,77.75,22.2
"2011","Little Eversden BUA","E34001242","Total",600,296,304,600,0,14,41.25,14.5
"2011","Rodmell BUA","E34001243","Total",527,276,251,473,54,10,27.75,19.0
"2011","Middle Rasen BUA","E34001244","Total",1174,566,608,1174,0,20,49.25,23.8
"2011","Dinnington (Newcastle upon Tyne) BUA","E34001245","Total",1483,721,762,1483,0,16,40.50,36.6
"2011","Broadwindsor BUA","E34001246","Total",558,265,293,539,19,12,32.50,17.2
"2011","Raunds BUA","E34001247","Total",8641,4303,4338,8528,113,98,228.00,37.9
"2011","Lerryn BUA","E34001248","Total",308,148,160,308,0,2,21.00,14.7
"2011","Bleasby BUA","E34001249","Total",824,391,433,788,36,24,42.00,19.6
"2011","East Grafton BUA","E34001250","Total",348,173,175,348,0,7,31.00,11.2
"2011","Tow Law BUA","E34001251","Total",2138,1047,1091,2113,25,10,60.75,35.2
"2011","Sandiway BUA","E34001252","Total",4430,2137,2293,4317,113,76,165.00,26.8
"2011","Writtle BUA","E34001253","Total",4840,2336,2504,4835,5,55,125.75,38.5
"2011","Kennford BUA","E34001254","Total",987,485,502,983,4,21,28.50,34.6
"2011","Uckinghall BUA","E34001255","Total",303,152,151,303,0,4,29.00,10.4
"2011","Greysouthen BUA","E34001256","Total",366,188,178,366,0,10,21.75,16.8
"2011","Long Crendon BUA","E34001257","Total",2335,1149,1186,2335,0,48,92.50,25.2
"2011","Rowde BUA","E34001258","Total",1223,584,639,1186,37,24,36.75,33.3
"2011","Cannock Wood BUA","E34001259","Total",912,445,467,912,0,14,39.75,22.9
"2011","Heapham BUA","E34001260","Total",102,52,50,102,0,1,74.75,1.4
"2011","St Erme BUA","E34001261","Total",1208,589,619,1208,0,14,25.00,48.3
"2011","Latton BUA","E34001262","Total",548,270,278,548,0,16,23.00,23.8
"2011","Halstead BUA","E34001263","Total",11906,5795,6111,11731,175,86,307.25,38.8
"2011","Newtown (Telford and Wrekin) BUA","E34001264","Total",824,422,402,154,670,25,28.75,28.7
"2011","Minley BUA","E34001265","Total",223,157,66,111,112,4,26.00,8.6
"2011","Icklingham BUA","E34001266","Total",423,217,206,423,0,9,26.25,16.1
"2011","Newport (Isle of Wight) BUA","E34001267","Total",24884,12911,11973,22924,1960,235,674.75,36.9
"2011","South Nutfield BUA","E34001268","Total",1922,952,970,1874,48,35,85.25,22.5
"2011","Brewood BUA","E34001269","Total",2614,1223,1391,2608,6,47,84.75,30.8
"2011","Stillington (Stockton-on-Tees) BUA","E34001270","Total",1210,588,622,1210,0,8,38.25,31.6
"2011","Fordham (East Cambridgeshire) BUA","E34001271","Total",2712,1336,1376,2712,0,37,109.00,24.9
"2011","Winterborne Zelston BUA","E34001272","Total",203,108,95,203,0,7,20.50,9.9
"2011","Thornborough BUA","E34001273","Total",641,319,322,641,0,30,37.25,17.2
"2011","Acle BUA","E34001274","Total",2317,1102,1215,2287,30,17,80.75,28.7
"2011","Rye Harbour BUA","E34001275","Total",448,226,222,448,0,0,28.75,15.6
"2011","Knighton (South Hams) BUA","E34001276","Total",1666,805,861,1666,0,30,61.75,27.0
"2011","Oare BUA","E34001277","Total",266,132,134,266,0,9,24.25,11.0
"2011","Beckley (South Oxfordshire) BUA","E34001278","Total",438,229,209,438,0,18,45.25,9.7
"2011","Shotteswell BUA","E34001279","Total",221,109,112,221,0,11,20.50,10.8
"2011","Great Glen BUA","E34001280","Total",2977,1420,1557,2977,0,77,99.75,29.8
"2011","Durweston BUA","E34001281","Total",398,173,225,355,43,11,24.50,16.2
"2011","Greylees BUA","E34001282","Total",1126,543,583,1117,9,27,27.00,41.7
"2011","Filkins BUA","E34001283","Total",434,221,213,434,0,11,31.50,13.8
"2011","Frittenden BUA","E34001284","Total",267,120,147,267,0,9,42.75,6.2
"2011","Great Offley BUA","E34001285","Total",748,377,371,741,7,8,31.00,24.1
"2011","Charlton Down BUA","E34001286","Total",1431,720,711,1430,1,17,38.25,37.4
"2011","Canon's Town BUA","E34001287","Total",538,269,269,535,3,6,23.75,22.7
"2011","Ingham (St. Edmundsbury) BUA","E34001288","Total",451,224,227,451,0,4,29.75,15.2
"2011","Gristhorpe BUA","E34001289","Total",397,195,202,397,0,3,23.75,16.7
"2011","Woodhall Spa BUA","E34001290","Total",4331,2083,2248,4195,136,80,264.50,16.4
"2011","Bramley BUA","E34001291","Total",4233,2069,2164,4190,43,75,128.00,33.1
"2011","Whipsnade BUA","E34001292","Total",279,146,133,279,0,7,28.50,9.8
"2011","Beckermet BUA","E34001293","Total",704,361,343,703,1,20,37.25,18.9
"2011","Morton (Broadland) BUA","E34001294","Total",223,112,111,223,0,5,20.75,10.7
"2011","Burton Agnes BUA","E34001295","Total",270,140,130,270,0,1,28.25,9.6
"2011","Little Downham BUA","E34001296","Total",1562,757,805,1546,16,23,69.25,22.6
"2011","Repton BUA","E34001297","Total",2629,1322,1307,2177,452,66,101.00,26.0
"2011","Crowland BUA","E34001298","Total",4211,2075,2136,4187,24,40,133.00,31.7
"2011","Sturminster Marshall BUA","E34001299","Total",1490,743,747,1490,0,30,65.00,22.9
"2011","Tarrant Monkton BUA","E34001300","Total",123,56,67,123,0,1,24.00,5.1
"2011","Raydon BUA","E34001301","Total",210,103,107,210,0,5,28.25,7.4
"2011","Streatley BUA","E34001302","Total",559,285,274,555,4,8,30.25,18.5
"2011","East Hoathly BUA","E34001303","Total",893,424,469,853,40,14,23.00,38.8
"2011","Reed BUA","E34001304","Total",310,148,162,310,0,8,24.25,12.8
"2011","Coveney BUA","E34001305","Total",424,198,226,424,0,9,21.00,20.2
"2011","Hexton BUA","E34001306","Total",123,68,55,123,0,5,21.25,5.8
"2011","Kemble BUA","E34001307","Total",779,387,392,779,0,15,40.50,19.2
"2011","Rodney Stoke BUA","E34001308","Total",269,132,137,261,8,11,20.75,13.0
"2011","St Briavels BUA","E34001309","Total",921,457,464,920,1,20,31.50,29.2
"2011","West Charleton BUA","E34001310","Total",504,238,266,504,0,6,32.25,15.6
"2011","Combs BUA","E34001311","Total",374,194,180,374,0,10,24.50,15.3
"2011","Papplewick BUA","E34001312","Total",369,187,182,369,0,8,20.25,18.2
"2011","Stokenchurch BUA","E34001313","Total",4056,2012,2044,4052,4,65,118.25,34.3
"2011","Boreham BUA","E34001314","Total",3244,1595,1649,3244,0,38,92.25,35.2
"2011","Christchurch BUA","E34001315","Total",833,410,423,833,0,12,27.25,30.6
"2011","Seaton Ross BUA","E34001316","Total",565,274,291,563,2,12,52.25,10.8
"2011","Pirton BUA","E34001317","Total",1274,596,678,1261,13,24,46.50,27.4
"2011","Gosberton BUA","E34001318","Total",1764,848,916,1718,46,7,72.75,24.2
"2011","South Wingfield BUA","E34001319","Total",1088,527,561,1088,0,10,49.50,22.0
"2011","Fuller's Moor BUA","E34001320","Total",211,100,111,211,0,4,21.50,9.8
"2011","Burton Salmon BUA","E34001321","Total",416,201,215,416,0,2,20.50,20.3
"2011","Ponteland BUA","E34001322","Total",10135,4921,5214,10076,59,239,550.50,18.4
"2011","Great Staughton BUA","E34001323","Total",896,448,448,896,0,13,31.75,28.2
"2011","Great Urswick BUA","E34001324","Total",281,145,136,281,0,7,20.75,13.5
"2011","Silverstone BUA","E34001325","Total",1907,965,942,1886,21,32,67.25,28.4
"2011","Braybrooke BUA","E34001326","Total",378,183,195,362,16,14,24.25,15.6
"2011","Great Hormead BUA","E34001327","Total",412,219,193,412,0,12,28.75,14.3
"2011","Wing BUA","E34001328","Total",2589,1272,1317,2522,67,46,68.75,37.7
"2011","Thornton-in-Craven BUA","E34001329","Total",431,194,237,387,44,7,21.25,20.3
"2011","Woburn BUA","E34001330","Total",933,454,479,933,0,15,31.25,29.9
"2011","Halford BUA","E34001331","Total",341,169,172,340,1,11,20.50,16.6
"2011","Riccall BUA","E34001332","Total",2216,1060,1156,2198,18,23,62.00,35.7
"2011","Findon BUA","E34001333","Total",1886,891,995,1886,0,27,68.75,27.4
"2011","Debenham BUA","E34001334","Total",2210,1048,1162,2207,3,54,71.50,30.9
"2011","Aston Rowant BUA","E34001335","Total",287,138,149,287,0,14,35.25,8.1
"2011","Wylam BUA","E34001336","Total",1412,678,734,1412,0,30,50.50,28.0
"2011","Tideswell BUA","E34001337","Total",1647,806,841,1647,0,24,56.00,29.4
"2011","Tetney BUA","E34001338","Total",1526,731,795,1496,30,35,62.25,24.5
"2011","Measham BUA","E34001339","Total",5209,2641,2568,5209,0,45,166.50,31.3
"2011","Nether Wallop BUA","E34001340","Total",294,132,162,294,0,20,34.50,8.5
"2011","Westerham BUA","E34001341","Total",3303,1623,1680,3287,16,54,122.50,27.0
"2011","Ipstones BUA","E34001342","Total",881,431,450,878,3,12,39.75,22.2
"2011","Titchmarsh BUA","E34001343","Total",598,303,295,598,0,12,40.50,14.8
"2011","Charvil BUA","E34001344","Total",3042,1522,1520,3036,6,77,77.00,39.5
"2011","Worrall BUA","E34001345","Total",1245,600,645,1245,0,14,38.75,32.1
"2011","Hoylandswaine BUA","E34001346","Total",814,408,406,814,0,17,36.25,22.5
"2011","Bubbenhall BUA","E34001347","Total",655,315,340,655,0,18,25.75,25.4
"2011","Greatford BUA","E34001348","Total",268,120,148,268,0,12,27.00,9.9
"2011","Cherhill BUA","E34001349","Total",572,282,290,572,0,10,36.50,15.7
"2011","Little Walsingham BUA","E34001350","Total",613,296,317,609,4,9,34.75,17.6
"2011","Brownhills West BUA","E34001351","Total",2169,1048,1121,2134,35,7,37.50,57.8
"2011","Charlwood BUA","E34001352","Total",972,478,494,959,13,18,64.25,15.1
"2011","Yaxham BUA","E34001353","Total",394,200,194,393,1,4,31.25,12.6
"2011","St James South Elmham BUA","E34001354","Total",205,101,104,205,0,6,28.75,7.1
"2011","Sudbrooke BUA","E34001355","Total",1788,862,926,1788,0,40,83.00,21.5
"2011","Gorran Haven BUA","E34001356","Total",893,424,469,829,64,17,55.00,16.2
"2011","Langwith BUA","E34001357","Total",2955,1469,1486,2867,88,15,81.50,36.3
"2011","Rampton (Bassetlaw) BUA","E34001358","Total",571,277,294,571,0,7,31.25,18.3
"2011","Fairford BUA","E34001359","Total",3236,1551,1685,3158,78,56,106.75,30.3
"2011","Zeal Monachorum BUA","E34001360","Total",413,195,218,413,0,0,21.25,19.4
"2011","Cleobury Mortimer BUA","E34001361","Total",2711,1354,1357,2711,0,35,86.00,31.5
"2011","Newbold Verdon BUA","E34001362","Total",2850,1394,1456,2838,12,29,80.00,35.6
"2011","Stalham BUA","E34001363","Total",3971,1898,2073,3919,52,32,150.50,26.4
"2011","Helperby BUA","E34001364","Total",831,423,408,831,0,16,26.75,31.1
"2011","Langwathby BUA","E34001365","Total",643,317,326,643,0,16,42.25,15.2
"2011","Stretton-on-Dunsmore BUA","E34001366","Total",1159,571,588,1158,1,26,46.25,25.1
"2011","Baddesley Ensor BUA","E34001367","Total",3318,1639,1679,3318,0,35,97.50,34.0
"2011","Bardney BUA","E34001368","Total",1655,787,868,1647,8,12,84.25,19.6
"2011","Sidbury BUA","E34001369","Total",457,218,239,457,0,7,33.00,13.8
"2011","Ramsey St Mary's BUA","E34001370","Total",907,447,460,898,9,14,24.00,37.8
"2011","Ravenstone BUA","E34001371","Total",1623,781,842,1595,28,24,50.50,32.1
"2011","Chinley BUA","E34001372","Total",1614,796,818,1607,7,33,59.50,27.1
"2011","Oakham BUA","E34001373","Total",10922,5260,5662,10432,490,201,339.50,32.2
"2011","Clapham (Arun) BUA","E34001374","Total",275,126,149,261,14,7,25.25,10.9
"2011","Thompson BUA","E34001375","Total",343,160,183,343,0,10,24.25,14.1
"2011","Badminton BUA","E34001376","Total",271,135,136,271,0,9,27.75,9.8
"2011","Hale BUA","E34001377","Total",1841,906,935,1841,0,18,64.25,28.7
"2011","Leyhill Prison BUA","E34001378","Total",625,570,55,123,502,0,21.50,29.1
"2011","Wethersfield Airfield BUA","E34001379","Total",431,236,195,400,31,9,166.50,2.6
"2011","Sapcote BUA","E34001380","Total",2442,1185,1257,2394,48,13,68.00,35.9
"2011","Clayworth BUA","E34001381","Total",419,201,218,419,0,11,26.00,16.1
"2011","Maiden Bradley BUA","E34001382","Total",331,156,175,331,0,6,23.75,13.9
"2011","East Ilsley BUA","E34001383","Total",538,258,280,527,11,9,27.75,19.4
"2011","Rockbourne BUA","E34001384","Total",167,79,88,167,0,4,26.75,6.2
"2011","Youlgreave BUA","E34001385","Total",1018,481,537,988,30,12,41.50,24.5
"2011","Norwell BUA","E34001386","Total",490,235,255,490,0,14,27.50,17.8
"2011","Standford Hill Prison BUA","E34001387","Total",1653,1451,202,415,1238,7,56.50,29.3
"2011","Barlow BUA","E34001388","Total",753,394,359,751,2,12,30.25,24.9
"2011","Oscroft BUA","E34001389","Total",419,211,208,419,0,19,21.00,20.0
"2011","East Bergholt BUA","E34001390","Total",2252,1115,1137,2190,62,56,133.25,16.9
"2011","Lytchett Matravers BUA","E34001391","Total",3315,1604,1711,3296,19,82,113.50,29.2
"2011","Brotton BUA","E34001392","Total",5394,2669,2725,5374,20,34,132.50,40.7
"2011","Osmington BUA","E34001393","Total",227,98,129,227,0,6,29.00,7.8
"2011","Westwood BUA","E34001394","Total",1162,540,622,1162,0,20,52.25,22.2
"2011","Brockham BUA","E34001395","Total",2583,1250,1333,2583,0,62,113.25,22.8
"2011","Upavon Army Camp BUA","E34001396","Total",410,200,210,400,10,31,43.00,9.5
"2011","Edgworth BUA","E34001397","Total",2321,1135,1186,2321,0,58,88.75,26.2
"2011","Okehampton BUA","E34001398","Total",7647,3719,3928,7532,115,65,211.50,36.2
"2011","Biddestone BUA","E34001399","Total",498,247,251,498,0,19,33.25,15.0
"2011","Bowling Green BUA","E34001400","Total",189,93,96,189,0,3,76.75,2.5
"2011","Great Wakering BUA","E34001401","Total",5400,2665,2735,5352,48,62,126.75,42.6
"2011","Bicknoller BUA","E34001402","Total",371,189,182,371,0,15,34.75,10.7
"2011","Blyton BUA","E34001403","Total",1162,559,603,1141,21,12,48.25,24.1
"2011","Beyton BUA","E34001404","Total",713,362,351,713,0,24,51.00,14.0
"2011","Acomb BUA","E34001405","Total",1106,543,563,1105,1,10,38.00,29.1
"2011","Wimbotsham BUA","E34001406","Total",664,318,346,664,0,5,38.50,17.2
"2011","Great Bourton BUA","E34001407","Total",308,156,152,308,0,9,22.00,14.0
"2011","Bainton BUA","E34001408","Total",290,142,148,290,0,14,20.50,14.1
"2011","Widmerpool BUA","E34001409","Total",339,151,188,277,62,9,20.25,16.7
"2011","Aylmerton BUA","E34001410","Total",222,112,110,222,0,3,26.50,8.4
"2011","Clehonger BUA","E34001411","Total",1070,530,540,1070,0,10,43.50,24.6
"2011","Oakhanger BUA","E34001412","Total",293,155,138,293,0,5,21.00,14.0
"2011","Teston BUA","E34001413","Total",637,305,332,637,0,15,26.75,23.8
"2011","Culverstone Green BUA","E34001414","Total",4001,1987,2014,4001,0,57,282.50,14.2
"2011","Martin (New Forest) BUA","E34001415","Total",413,202,211,413,0,12,28.50,14.5
"2011","Clitheroe BUA","E34001416","Total",14765,7190,7575,14576,189,210,408.00,36.2
"2011","Inkpen BUA","E34001417","Total",283,142,141,283,0,9,29.50,9.6
"2011","Carbrooke BUA","E34001418","Total",567,282,285,567,0,9,27.75,20.4
"2011","Whaplode Drove BUA","E34001419","Total",535,272,263,535,0,8,37.25,14.4
"2011","Inkford BUA","E34001420","Total",303,153,150,303,0,9,26.75,11.3
"2011","Alderminster BUA","E34001421","Total",243,119,124,242,1,9,25.00,9.7
"2011","Helsby BUA","E34001422","Total",5166,2503,2663,5103,63,94,188.50,27.4
"2011","Snettisham BUA","E34001423","Total",2570,1196,1374,2535,35,26,100.00,25.7
"2011","Southminster BUA","E34001424","Total",4025,2011,2014,3965,60,35,91.25,44.1
"2011","Halsall BUA","E34001425","Total",242,116,126,242,0,0,20.25,12.0
"2011","Burnham Overy Staithe BUA","E34001426","Total",134,69,65,134,0,8,24.25,5.5
"2011","Stadhampton BUA","E34001427","Total",702,345,357,702,0,14,26.00,27.0
"2011","Crowle (North Lincolnshire) BUA","E34001428","Total",3928,1971,1957,3896,32,52,144.50,27.2
"2011","Lowca BUA","E34001429","Total",888,451,437,888,0,13,21.75,40.8
"2011","Petersfield BUA","E34001430","Total",14974,7124,7850,14808,166,282,466.75,32.1
"2011","Plaistow BUA","E34001431","Total",395,198,197,395,0,10,26.50,14.9
"2011","Higher Boscaswell BUA","E34001432","Total",668,328,340,668,0,11,27.50,24.3
"2011","Middle Wallop Airfield BUA","E34001433","Total",1116,637,479,924,192,54,69.50,16.1
"2011","Louth BUA","E34001434","Total",16419,7839,8580,16166,253,224,547.50,30.0
"2011","Pillerton Priors BUA","E34001435","Total",294,147,147,294,0,5,21.00,14.0
"2011","Burniston BUA","E34001436","Total",1523,719,804,1523,0,23,76.50,19.9
"2011","Martin (North Kesteven) BUA","E34001437","Total",684,328,356,646,38,8,24.50,27.9
"2011","East Haddon BUA","E34001438","Total",643,320,323,643,0,22,38.75,16.6
"2011","Langham (North Norfolk) BUA","E34001439","Total",372,184,188,372,0,5,30.25,12.3
"2011","Brill BUA","E34001440","Total",1141,530,611,1141,0,29,40.25,28.3
"2011","Abbeytown BUA","E34001441","Total",819,397,422,819,0,7,26.25,31.2
"2011","Westfield (Rother) BUA","E34001442","Total",1533,735,798,1533,0,11,67.75,22.6
"2011","Gurney Slade BUA","E34001443","Total",604,299,305,596,8,10,29.00,20.8
"2011","Rye BUA","E34001444","Total",4773,2291,2482,4734,39,37,174.25,27.4
"2011","Ashington (Northumberland) BUA","E34001445","Total",27670,13542,14128,27454,216,203,606.50,45.6
"2011","Crowfield BUA","E34001446","Total",361,181,180,361,0,5,26.50,13.6
"2011","Hockley Heath BUA","E34001447","Total",1604,800,804,1604,0,42,81.75,19.6
"2011","Chalkhouse Green BUA","E34001448","Total",215,118,97,202,13,9,21.00,10.2
"2011","Westham BUA","E34001449","Total",2085,954,1131,2064,21,22,75.00,27.8
"2011","Hoddlesden BUA","E34001450","Total",1239,627,612,1239,0,17,33.75,36.7
"2011","Tingewick BUA","E34001451","Total",1093,538,555,1093,0,25,36.50,29.9
"2011","Thorrington (West) BUA","E34001452","Total",485,230,255,399,86,9,36.75,13.2
"2011","Wix BUA","E34001453","Total",494,242,252,494,0,15,31.50,15.7
"2011","Henton BUA","E34001454","Total",501,250,251,445,56,9,32.25,15.5
"2011","Whitchurch (Basingstoke and Deane) BUA","E34001455","Total",4676,2249,2427,4619,57,88,148.25,31.5
"2011","Shouldham BUA","E34001456","Total",605,271,334,558,47,12,39.75,15.2
"2011","Moulton Seas End BUA","E34001457","Total",634,306,328,634,0,6,33.25,19.1
"2011","Swithland BUA","E34001458","Total",217,114,103,217,0,11,23.25,9.3
"2011","Brasted Chart BUA","E34001459","Total",246,116,130,246,0,11,39.75,6.2
"2011","Blakesley BUA","E34001460","Total",508,251,257,505,3,23,32.75,15.5
"2011","Newmarket BUA","E34001461","Total",20384,10107,10277,20227,157,169,766.25,26.6
"2011","Reedham BUA","E34001462","Total",1207,583,624,1165,42,11,53.75,22.5
"2011","Broughton (North Lincolnshire) BUA","E34001463","Total",4677,2279,2398,4671,6,40,125.25,37.3
"2011","Woolacombe BUA","E34001464","Total",840,415,425,826,14,13,47.75,17.6
"2011","South Moreton BUA","E34001465","Total",420,210,210,420,0,16,22.50,18.7
"2011","Barnburgh BUA","E34001466","Total",1924,919,1005,1924,0,23,64.75,29.7
"2011","Stretton-on-Fosse BUA","E34001467","Total",439,205,234,439,0,9,22.25,19.7
"2011","Rattlesden BUA","E34001468","Total",320,168,152,320,0,7,21.25,15.1
"2011","Beenham BUA","E34001469","Total",770,388,382,770,0,28,39.25,19.6
"2011","Lubenham BUA","E34001470","Total",781,385,396,781,0,11,33.50,23.3
"2011","Bradninch BUA","E34001471","Total",1881,895,986,1881,0,30,59.25,31.7
"2011","Tuddenham St Martin BUA","E34001472","Total",353,170,183,353,0,9,22.25,15.9
"2011","Ashburton BUA","E34001473","Total",3346,1573,1773,3302,44,60,103.50,32.3
"2011","Whittlesford BUA","E34001474","Total",1536,789,747,1535,1,53,56.00,27.4
"2011","Culcheth BUA","E34001475","Total",6708,3196,3512,6653,55,155,201.50,33.3
"2011","Speen BUA","E34001476","Total",637,303,334,637,0,20,40.75,15.6
"2011","Chesterton BUA","E34001477","Total",850,459,391,769,81,17,33.50,25.4
"2011","Peldon BUA","E34001478","Total",559,291,268,538,21,13,40.50,13.8
"2011","Horton-cum-Studley BUA","E34001479","Total",455,218,237,455,0,20,38.50,11.8
"2011","Stoke St Mary BUA","E34001480","Total",421,214,207,421,0,9,20.50,20.5
"2011","Heswall BUA","E34001481","Total",29789,14185,15604,29650,139,623,1017.75,29.3
"2011","Leigh (West Dorset) BUA","E34001482","Total",480,225,255,447,33,14,36.50,13.2
"2011","Appleton Roebuck BUA","E34001483","Total",792,391,401,792,0,17,31.25,25.3
"2011","Harmer Hill BUA","E34001484","Total",299,141,158,299,0,5,23.25,12.9
"2011","Shotley BUA","E34001485","Total",831,423,408,831,0,7,22.25,37.3
"2011","Axbridge BUA","E34001486","Total",2057,986,1071,2001,56,53,64.00,32.1
"2011","Constantine Bay BUA","E34001487","Total",225,101,124,163,62,4,42.50,5.3
"2011","Mears Ashby BUA","E34001488","Total",473,234,239,473,0,14,27.00,17.5
"2011","Willington (Bedford) BUA","E34001489","Total",751,363,388,751,0,18,52.25,14.4
"2011","Finchingfield BUA","E34001490","Total",711,333,378,711,0,20,38.00,18.7
"2011","Sheerness BUA","E34001491","Total",11938,5858,6080,11849,89,66,301.25,39.6
"2011","North Duffield BUA","E34001492","Total",1317,648,669,1317,0,28,36.50,36.1
"2011","Driffield BUA","E34001493","Total",13080,6281,6799,12873,207,167,339.50,38.5
"2011","Norleywood BUA","E34001494","Total",342,181,161,338,4,13,23.25,14.7
"2011","Tenbury Wells BUA","E34001495","Total",3849,1869,1980,3797,52,48,138.50,27.8
"2011","Hanley Swan BUA","E34001496","Total",627,287,340,593,34,1,44.00,14.2
"2011","Tibberton (Wychavon) BUA","E34001497","Total",598,297,301,598,0,11,37.25,16.1
"2011","Martin Hussingtree BUA","E34001498","Total",241,124,117,241,0,11,24.75,9.7
"2011","Old Leake BUA","E34001499","Total",1242,590,652,1242,0,21,39.50,31.4
"2011","Corby Glen BUA","E34001500","Total",1017,488,529,1017,0,22,46.00,22.1
"2011","Loxwood BUA","E34001501","Total",956,461,495,956,0,25,43.00,22.2
"2011","Llangrove BUA","E34001502","Total",442,220,222,442,0,16,37.00,11.9
"2011","Potter Heigham BUA","E34001503","Total",829,408,421,807,22,4,34.50,24.0
"2011","Retford BUA","E34001504","Total",22023,10756,11267,21742,281,270,642.25,34.3
"2011","North Waltham BUA","E34001505","Total",870,449,421,868,2,19,32.00,27.2
"2011","Bottom o' th' Moor BUA","E34001506","Total",808,403,405,808,0,11,22.75,35.5
"2011","Balcombe BUA","E34001507","Total",1424,707,717,1377,47,31,57.00,25.0
"2011","Houghton (Huntingdonshire) BUA","E34001508","Total",1391,683,708,1391,0,42,80.25,17.3
"2011","Arlingham BUA","E34001509","Total",459,226,233,459,0,15,20.25,22.7
"2011","Rusper BUA","E34001510","Total",647,308,339,637,10,8,34.00,19.0
"2011","Shorwell BUA","E34001511","Total",433,192,241,433,0,7,27.50,15.7
"2011","Eltisley BUA","E34001512","Total",401,197,204,399,2,10,34.75,11.5
"2011","Swinderby BUA","E34001513","Total",491,260,231,462,29,8,29.75,16.5
"2011","Highley BUA","E34001514","Total",3133,1538,1595,3133,0,37,87.00,36.0
"2011","Layer-de-la-Haye BUA","E34001515","Total",1656,838,818,1656,0,35,106.50,15.5
"2011","Wollaston BUA","E34001516","Total",3491,1722,1769,3491,0,48,111.50,31.3
"2011","Horley BUA","E34001517","Total",336,158,178,336,0,13,25.75,13.0
"2011","Radcliffe on Trent BUA","E34001518","Total",7510,3580,3930,7384,126,111,236.00,31.8
"2011","Knowle BUA","E34001519","Total",1511,804,707,1439,72,15,30.75,49.1
"2011","Ruskington BUA","E34001520","Total",5637,2727,2910,5621,16,73,182.75,30.8
"2011","Glazebury BUA","E34001521","Total",1068,527,541,1068,0,18,46.25,23.1
"2011","Thurlaston BUA","E34001522","Total",807,404,403,807,0,16,23.50,34.3
"2011","Patrington BUA","E34001523","Total",1501,764,737,1474,27,9,51.25,29.3
"2011","Locking BUA","E34001524","Total",1742,843,899,1742,0,16,50.50,34.5
"2011","Stogumber BUA","E34001525","Total",414,194,220,412,2,4,30.75,13.5
"2011","Arnside BUA","E34001526","Total",2334,1097,1237,2285,49,29,105.50,22.1
"2011","North Somercotes BUA","E34001527","Total",1732,848,884,1732,0,14,87.00,19.9
"2011","Christian Malford BUA","E34001528","Total",540,263,277,540,0,21,41.00,13.2
"2011","Otley BUA","E34001529","Total",676,342,334,676,0,12,37.00,18.3
"2011","Roydon BUA","E34001530","Total",1582,778,804,1578,4,27,74.75,21.2
"2011","Fownhope BUA","E34001531","Total",779,359,420,779,0,12,40.25,19.4
"2011","Gargrave BUA","E34001532","Total",1755,814,941,1717,38,24,52.75,33.3
"2011","Felsham BUA","E34001533","Total",448,222,226,448,0,9,24.00,18.7
"2011","Melbourne (South Derbyshire) BUA","E34001534","Total",4843,2391,2452,4828,15,108,125.00,38.7
"2011","Penny Bridge BUA","E34001535","Total",488,240,248,488,0,11,25.75,19.0
"2011","Woodbury BUA","E34001536","Total",1605,763,842,1605,0,41,68.25,23.5
"2011","Wigton BUA","E34001537","Total",5831,2785,3046,5743,88,62,194.50,30.0
"2011","Bromham (Wiltshire) BUA","E34001538","Total",1080,540,540,1080,0,21,39.75,27.2
"2011","Welland BUA","E34001539","Total",903,431,472,855,48,25,41.50,21.8
"2011","Ryall BUA","E34001540","Total",846,374,472,808,38,8,35.25,24.0
"2011","Castle Hedingham BUA","E34001541","Total",1063,534,529,1063,0,21,46.25,23.0
"2011","Hessett BUA","E34001542","Total",464,216,248,464,0,6,26.75,17.3
"2011","Burbage BUA","E34001543","Total",1772,868,904,1772,0,49,78.25,22.6
"2011","Monkton Farleigh BUA","E34001544","Total",460,229,231,459,1,12,21.75,21.1
"2011","Leominster BUA","E34001545","Total",10938,5310,5628,10817,121,72,321.75,34.0
"2011","Bratton BUA","E34001546","Total",1248,622,626,1248,0,36,63.00,19.8
"2011","Harwell BUA","E34001547","Total",1998,946,1052,1988,10,52,76.50,26.1
"2011","Oxenpill BUA","E34001548","Total",828,412,416,827,1,8,43.25,19.1
"2011","Blackmore End BUA","E34001549","Total",846,418,428,846,0,33,64.50,13.1
"2011","Whaddon BUA","E34001550","Total",533,260,273,533,0,14,23.00,23.2
"2011","Huby (Harrogate) BUA","E34001551","Total",756,370,386,756,0,35,40.75,18.6
"2011","Weybourne BUA","E34001552","Total",543,265,278,543,0,3,35.50,15.3
"2011","Twyford (Winchester) BUA","E34001553","Total",1412,659,753,1377,35,53,76.25,18.5
"2011","Alburgh BUA","E34001554","Total",410,195,215,410,0,6,20.75,19.8
"2011","Tuxford BUA","E34001555","Total",2649,1299,1350,2625,24,30,87.25,30.4
"2011","Castle Bytham BUA","E34001556","Total",492,241,251,492,0,16,32.50,15.1
"2011","Bamford BUA","E34001557","Total",859,419,440,859,0,12,27.25,31.5
"2011","High Littleton BUA","E34001558","Total",1639,779,860,1571,68,20,58.25,28.1
"2011","Dickleburgh BUA","E34001559","Total",1096,552,544,1096,0,7,42.25,25.9
"2011","Doddinghurst Common BUA","E34001560","Total",141,72,69,141,0,2,22.50,6.3
"2011","Praze-an-Beeble BUA","E34001561","Total",1352,667,685,1352,0,14,31.00,43.6
"2011","Woodford BUA","E34001562","Total",1461,729,732,1452,9,26,48.50,30.1
"2011","Wickhamford BUA","E34001563","Total",747,371,376,745,2,8,46.50,16.1
"2011","Uffington (Vale of White Horse) BUA","E34001564","Total",783,377,406,783,0,18,42.50,18.4
"2011","Wick (South Gloucestershire) BUA","E34001565","Total",1989,977,1012,1989,0,25,87.50,22.7
"2011","Yorkley BUA","E34001566","Total",2629,1292,1337,2629,0,24,132.50,19.8
"2011","Great Clifton BUA","E34001567","Total",600,282,318,578,22,4,22.50,26.7
"2011","RAF Wyton BUA","E34001568","Total",1383,678,705,1383,0,19,216.75,6.4
"2011","Mollington (Cheshire West and Chester) BUA","E34001569","Total",626,288,338,594,32,14,48.75,12.8
"2011","Ram Lane BUA","E34001570","Total",141,67,74,141,0,3,20.50,6.9
"2011","Coleshill (Chiltern) BUA","E34001571","Total",409,199,210,409,0,15,44.00,9.3
"2011","Sandhurst (Tewkesbury) BUA","E34001572","Total",469,233,236,469,0,15,26.25,17.9
"2011","Sixpenny Handley BUA","E34001573","Total",906,436,470,906,0,9,30.00,30.2
"2011","St Martin's BUA","E34001574","Total",2471,1224,1247,2460,11,35,75.50,32.7
"2011","Claybrooke Magna BUA","E34001575","Total",616,303,313,616,0,8,23.00,26.8
"2011","Mosterton BUA","E34001576","Total",604,295,309,604,0,8,28.00,21.6
"2011","Freeland BUA","E34001577","Total",1560,759,801,1487,73,36,49.00,31.8
"2011","Hill Ridware BUA","E34001578","Total",857,419,438,857,0,12,32.00,26.8
"2011","Gayton (King's Lynn and West Norfolk) BUA","E34001579","Total",1321,635,686,1299,22,24,72.50,18.2
"2011","Stallingborough BUA","E34001580","Total",1073,511,562,1033,40,14,48.00,22.4
"2011","Sturminster Newton BUA","E34001581","Total",3501,1716,1785,3481,20,42,110.75,31.6
"2011","Hayfield BUA","E34001582","Total",1940,954,986,1938,2,33,54.25,35.8
"2011","Old Newton BUA","E34001583","Total",828,411,417,828,0,10,32.25,25.7
"2011","Tackley BUA","E34001584","Total",877,416,461,877,0,28,36.00,24.4
"2011","Wybunbury BUA","E34001585","Total",854,422,432,854,0,14,39.00,21.9
"2011","Cerne Abbas BUA","E34001586","Total",784,354,430,760,24,9,38.75,20.2
"2011","Wicken Green Village BUA","E34001587","Total",771,389,382,771,0,1,35.00,22.0
"2011","Wootton Courtenay BUA","E34001588","Total",264,121,143,261,3,2,31.25,8.4
"2011","Tilbrook BUA","E34001589","Total",370,197,173,370,0,9,26.00,14.2
"2011","Claverley BUA","E34001590","Total",549,271,278,549,0,8,44.00,12.5
"2011","Moulton (South Holland) BUA","E34001591","Total",1527,763,764,1502,25,23,75.00,20.4
"2011","Ellerton BUA","E34001592","Total",388,201,187,388,0,5,21.00,18.5
"2011","Muston BUA","E34001593","Total",339,168,171,339,0,2,23.25,14.6
"2011","Pilton BUA","E34001594","Total",646,326,320,646,0,13,54.75,11.8
"2011","Walsham Le Willows BUA","E34001595","Total",1213,604,609,1213,0,20,86.25,14.1
"2011","Norton Lindsey BUA","E34001596","Total",326,160,166,326,0,14,36.25,9.0
"2011","Kirton End BUA","E34001597","Total",373,176,197,373,0,8,25.75,14.5
"2011","Upton Grey BUA","E34001598","Total",449,223,226,449,0,11,45.00,10.0
"2011","North Newbald BUA","E34001599","Total",1115,544,571,1113,2,16,40.25,27.7
"2011","South Croxton BUA","E34001600","Total",261,129,132,261,0,6,22.50,11.6
"2011","Moresby Parks BUA","E34001601","Total",1288,631,657,1256,32,18,37.50,34.3
"2011","Mattishall BUA","E34001602","Total",2315,1099,1216,2303,12,33,99.00,23.4
"2011","Helpringham BUA","E34001603","Total",828,401,427,828,0,15,43.50,19.0
"2011","Bodmin BUA","E34001604","Total",14614,7078,7536,14353,261,157,455.75,32.1
"2011","Michelmersh BUA","E34001605","Total",881,446,435,881,0,31,67.50,13.1
"2011","Wilbarston BUA","E34001606","Total",753,368,385,751,2,13,26.25,28.7
"2011","Alpington BUA","E34001607","Total",650,311,339,633,17,4,27.75,23.4
"2011","Tunstall BUA","E34001608","Total",293,143,150,293,0,4,22.25,13.2
"2011","Caister-on-Sea BUA","E34001609","Total",8901,4284,4617,8847,54,66,269.25,33.1
"2011","Mere Brow BUA","E34001610","Total",494,241,253,494,0,5,30.00,16.5
"2011","Ramsey Forty Foot BUA","E34001611","Total",596,303,293,596,0,11,22.25,26.8
"2011","Little Totham BUA","E34001612","Total",702,359,343,702,0,18,22.00,31.9
"2011","Widdington BUA","E34001613","Total",504,256,248,504,0,18,47.00,10.7
"2011","Monks Eleigh BUA","E34001614","Total",505,237,268,505,0,7,33.25,15.2
"2011","Weston (Stafford) BUA","E34001615","Total",965,476,489,965,0,27,38.25,25.2
"2011","Gislingham BUA","E34001616","Total",669,343,326,669,0,9,49.00,13.7
"2011","Stannington Station BUA","E34001617","Total",333,177,156,328,5,7,20.75,16.0
"2011","Tarrant Keyneston BUA","E34001618","Total",310,154,156,310,0,2,20.25,15.3
"2011","Allerston BUA","E34001619","Total",302,146,156,302,0,7,21.50,14.0
"2011","Great Green BUA","E34001620","Total",286,145,141,286,0,5,20.25,14.1
"2011","Costock BUA","E34001621","Total",337,171,166,337,0,8,31.00,10.9
"2011","Scotton (West Lindsey) BUA","E34001622","Total",642,297,345,585,57,15,30.25,21.2
"2011","Great Sampford BUA","E34001623","Total",586,302,284,586,0,14,22.00,26.6
"2011","Corpusty BUA","E34001624","Total",505,241,264,503,2,4,39.50,12.8
"2011","Torksey Lock BUA","E34001625","Total",516,243,273,516,0,0,29.00,17.8
"2011","Farrington Gurney BUA","E34001626","Total",901,456,445,901,0,21,39.50,22.8
"2011","Buckingham Park BUA","E34001627","Total",1748,853,895,1748,0,30,21.75,80.4
"2011","Cranwell BUA","E34001628","Total",1372,681,691,1372,0,24,41.00,33.5
"2011","Somersham (Huntingdonshire) BUA","E34001629","Total",3524,1755,1769,3512,12,45,117.00,30.1
"2011","Sutton Veny BUA","E34001630","Total",734,347,387,712,22,25,34.00,21.6
"2011","Skelton (York) BUA","E34001631","Total",1549,762,787,1549,0,36,57.25,27.1
"2011","Ball Hill BUA","E34001632","Total",457,218,239,456,1,16,28.50,16.0
"2011","Slaley BUA","E34001633","Total",711,360,351,671,40,18,20.25,35.1
"2011","Ashby cum Fenby BUA","E34001634","Total",249,127,122,249,0,6,20.50,12.1
"2011","Swaffham Prior BUA","E34001635","Total",841,408,433,832,9,15,42.25,19.9
"2011","Bagnall BUA","E34001636","Total",425,207,218,425,0,5,20.75,20.5
"2011","Woodsetts BUA","E34001637","Total",1746,842,904,1746,0,34,66.75,26.2
"2011","All Cannings BUA","E34001638","Total",649,311,338,649,0,17,34.25,18.9
"2011","Longstanton BUA","E34001639","Total",2294,1156,1138,2294,0,25,115.50,19.9
"2011","Caxton BUA","E34001640","Total",572,289,283,572,0,14,35.75,16.0
"2011","Stoke-by-Nayland BUA","E34001641","Total",400,186,214,393,7,8,25.75,15.5
"2011","Wortham BUA","E34001642","Total",389,200,189,389,0,6,58.25,6.7
"2011","Milverton BUA","E34001643","Total",1112,534,578,1108,4,38,57.75,19.3
"2011","Cornhill on Tweed BUA","E34001644","Total",347,174,173,347,0,11,22.25,15.6
"2011","Devizes BUA","E34001645","Total",18064,8730,9334,17904,160,276,528.25,34.2
"2011","Yarpole BUA","E34001646","Total",285,132,153,285,0,9,22.75,12.5
"2011","Blisworth BUA","E34001647","Total",1591,760,831,1591,0,14,52.00,30.6
"2011","Easton on the Hill BUA","E34001648","Total",1015,488,527,1015,0,18,46.25,21.9
"2011","Colne Engaine BUA","E34001649","Total",1008,502,506,1008,0,30,25.75,39.1
"2011","Enstone BUA","E34001650","Total",849,402,447,816,33,15,42.50,20.0
"2011","Winslow BUA","E34001651","Total",4407,2132,2275,4356,51,94,124.00,35.5
"2011","Wilburton BUA","E34001652","Total",1013,503,510,1013,0,16,73.25,13.8
"2011","Hunton BUA","E34001653","Total",414,212,202,414,0,8,20.75,20.0
"2011","Bromley Green BUA","E34001654","Total",342,153,189,324,18,3,35.75,9.6
"2011","Lingdale BUA","E34001655","Total",1423,709,714,1419,4,4,37.50,37.9
"2011","Darenth BUA","E34001656","Total",2481,1212,1269,2481,0,19,42.50,58.4
"2011","Bucknell (Shropshire) BUA","E34001657","Total",717,357,360,717,0,14,48.25,14.9
"2011","Keinton Mandeville BUA","E34001658","Total",1068,516,552,1020,48,28,56.00,19.1
"2011","Pannal BUA","E34001659","Total",2219,1079,1140,2158,61,89,119.75,18.5
"2011","Ellington (Huntingdonshire) BUA","E34001660","Total",585,271,314,561,24,15,25.50,22.9
"2011","Trefonen BUA","E34001661","Total",777,366,411,777,0,14,38.50,20.2
"2011","Everton (New Forest) BUA","E34001662","Total",1635,769,866,1635,0,13,66.75,24.5
"2011","Orford BUA","E34001663","Total",713,356,357,713,0,14,41.75,17.1
"2011","Welford BUA","E34001664","Total",1043,516,527,1043,0,22,39.75,26.2
"2011","St Merryn BUA","E34001665","Total",599,296,303,599,0,3,26.00,23.0
"2011","Lapford BUA","E34001666","Total",867,430,437,867,0,8,29.50,29.4
"2011","Burghfield BUA","E34001667","Total",355,168,187,346,9,4,23.25,15.3
"2011","Worthen BUA","E34001668","Total",311,166,145,311,0,2,21.00,14.8
"2011","Sandy Cross BUA","E34001669","Total",272,139,133,272,0,9,26.50,10.3
"2011","Great Ayton BUA","E34001670","Total",4518,2196,2322,4517,1,77,123.00,36.7
"2011","Stretham BUA","E34001671","Total",1831,922,909,1830,1,37,58.25,31.4
"2011","Cuckfield BUA","E34001672","Total",3500,1648,1852,3481,19,97,141.75,24.7
"2011","Flimwell BUA","E34001673","Total",1100,563,537,1083,17,21,33.50,32.8
"2011","Cononley BUA","E34001674","Total",975,491,484,975,0,22,28.25,34.5
"2011","Upper Tankersley BUA","E34001675","Total",395,189,206,395,0,1,53.75,7.3
"2011","Winchmore Hill BUA","E34001676","Total",627,311,316,627,0,7,30.25,20.7
"2011","Endmoor BUA","E34001677","Total",661,314,347,661,0,13,36.25,18.2
"2011","Little Harrowden BUA","E34001678","Total",892,419,473,892,0,10,30.00,29.7
"2011","Failand BUA","E34001679","Total",691,351,340,691,0,15,40.25,17.2
"2011","Croston BUA","E34001680","Total",2917,1422,1495,2872,45,36,93.25,31.3
"2011","Rawcliffe BUA","E34001681","Total",1542,752,790,1501,41,8,47.00,32.8
"2011","Freethorpe BUA","E34001682","Total",995,498,497,995,0,15,38.75,25.7
"2011","Stewkley BUA","E34001683","Total",1840,914,926,1826,14,56,75.25,24.5
"2011","Leedstown BUA","E34001684","Total",267,130,137,267,0,0,23.00,11.6
"2011","Hoveringham BUA","E34001685","Total",359,182,177,359,0,10,21.50,16.7
"2011","Cotgrave BUA","E34001686","Total",7203,3502,3701,7084,119,62,148.00,48.7
"2011","Embleton BUA","E34001687","Total",412,189,223,412,0,3,24.25,17.0
"2011","Lea Valley BUA","E34001688","Total",611,288,323,611,0,13,27.00,22.6
"2011","Braunston-in-Rutland BUA","E34001689","Total",502,248,254,502,0,21,27.75,18.1
"2011","Champneys College BUA","E34001690","Total",532,272,260,524,8,20,23.75,22.4
"2011","Grafty Green BUA","E34001691","Total",476,235,241,460,16,7,22.75,20.9
"2011","Cottingham BUA","E34001692","Total",1320,649,671,1301,19,26,56.00,23.6
"2011","Rockland St Mary BUA","E34001693","Total",810,420,390,810,0,21,43.00,18.8
"2011","Harmston BUA","E34001694","Total",709,349,360,709,0,21,31.00,22.9
"2011","Ulleskelf BUA","E34001695","Total",650,325,325,650,0,10,28.75,22.6
"2011","Wingate BUA","E34001696","Total",5134,2470,2664,5114,20,36,137.25,37.4
"2011","Sampford Peverell BUA","E34001697","Total",1302,634,668,1302,0,29,45.00,28.9
"2011","Pakenham BUA","E34001698","Total",592,292,300,592,0,10,33.25,17.8
"2011","Great Addington BUA","E34001699","Total",327,166,161,327,0,10,22.00,14.9
"2011","Kirkby Lonsdale BUA","E34001700","Total",1843,886,957,1694,149,46,48.25,38.2
"2011","Castle Rising BUA","E34001701","Total",216,105,111,216,0,4,22.00,9.8
"2011","Great Kimble BUA","E34001702","Total",698,351,347,698,0,8,23.25,30.0
"2011","Oakridge Lynch BUA","E34001703","Total",280,136,144,280,0,8,24.00,11.7
"2011","Elland BUA","E34001704","Total",15625,7568,8057,15507,118,141,491.00,31.8
"2011","Grampound BUA","E34001705","Total",537,258,279,526,11,9,32.50,16.5
"2011","Cullingworth BUA","E34001706","Total",2596,1225,1371,2596,0,50,74.25,35.0
"2011","Potterspury BUA","E34001707","Total",1453,719,734,1453,0,21,46.00,31.6
"2011","Connor Downs BUA","E34001708","Total",1202,569,633,1179,23,6,38.50,31.2
"2011","Orwell BUA","E34001709","Total",1035,491,544,1035,0,38,50.75,20.4
"2011","Chelston BUA","E34001710","Total",442,220,222,442,0,8,46.50,9.5
"2011","Bishop's Stortford BUA","E34001711","Total",37838,18506,19332,37322,516,785,850.25,44.5
"2011","Bowerchalke BUA","E34001712","Total",379,176,203,379,0,16,27.50,13.8
"2011","Toll Bar BUA","E34001713","Total",1226,586,640,1226,0,6,34.25,35.8
"2011","Walkeringham BUA","E34001714","Total",652,312,340,619,33,12,58.25,11.2
"2011","Kenilworth BUA","E34001715","Total",22413,10955,11458,22294,119,512,596.00,37.6
"2011","Much Wenlock BUA","E34001716","Total",2211,1036,1175,2148,63,33,77.25,28.6
"2011","Chardstock BUA","E34001717","Total",284,134,150,284,0,2,31.75,8.9
"2011","East Drayton BUA","E34001718","Total",252,132,120,252,0,7,25.75,9.8
"2011","Tockwith BUA","E34001719","Total",1457,717,740,1457,0,31,90.75,16.1
"2011","Apperknowle BUA","E34001720","Total",288,145,143,288,0,4,27.00,10.7
"2011","Hartwell BUA","E34001721","Total",1875,944,931,1853,22,32,51.00,36.8
"2011","Burham BUA","E34001722","Total",1195,579,616,1195,0,8,27.25,43.9
"2011","Leconfield BUA","E34001723","Total",2127,1117,1010,2029,98,32,215.00,9.9
"2011","Wellow (Newark and Sherwood) BUA","E34001724","Total",470,232,238,470,0,9,28.75,16.3
"2011","Digby BUA","E34001725","Total",621,318,303,621,0,10,27.25,22.8
"2011","Scorton BUA","E34001726","Total",1012,492,520,934,78,18,25.75,39.3
"2011","Haslington BUA","E34001727","Total",4855,2334,2521,4762,93,108,116.25,41.8
"2011","North Mymms BUA","E34001728","Total",274,102,172,180,94,11,20.50,13.4
"2011","Bearley BUA","E34001729","Total",724,342,382,695,29,8,36.75,19.7
"2011","Germoe BUA","E34001730","Total",175,86,89,175,0,0,27.75,6.3
"2011","Unstone Green BUA","E34001731","Total",993,509,484,993,0,5,26.75,37.1
"2011","Aust BUA","E34001732","Total",226,115,111,226,0,4,28.50,7.9
"2011","Hungerford BUA","E34001733","Total",5100,2491,2609,5063,37,67,144.75,35.2
"2011","Stonesfield BUA","E34001734","Total",1527,742,785,1527,0,29,53.00,28.8
"2011","Godolphin Cross BUA","E34001735","Total",710,354,356,710,0,13,25.50,27.8
"2011","Shilbottle BUA","E34001736","Total",1834,905,929,1834,0,20,54.25,33.8
"2011","Swavesey BUA","E34001737","Total",2463,1245,1218,2463,0,47,86.25,28.6
"2011","Barningham BUA","E34001738","Total",956,484,472,956,0,18,37.75,25.3
"2011","Countesthorpe BUA","E34001739","Total",6377,3100,3277,6344,33,95,167.00,38.2
"2011","St Keverne BUA","E34001740","Total",939,456,483,939,0,11,25.00,37.6
"2011","Ravensmoor BUA","E34001741","Total",291,148,143,291,0,8,22.25,13.1
"2011","Kilmington BUA","E34001742","Total",830,393,437,826,4,11,47.75,17.4
"2011","Denton (South Northamptonshire) BUA","E34001743","Total",739,355,384,739,0,13,27.50,26.9
"2011","Fulford BUA","E34001744","Total",650,314,336,650,0,17,30.25,21.5
"2011","Burton Lazars BUA","E34001745","Total",423,211,212,423,0,9,32.00,13.2
"2011","Elder Street BUA","E34001746","Total",851,528,323,611,240,12,75.25,11.3
"2011","Hoby BUA","E34001747","Total",269,126,143,269,0,12,20.50,13.1
"2011","Rooks Bridge BUA","E34001748","Total",389,197,192,389,0,10,20.75,18.7
"2011","Shebbear BUA","E34001749","Total",707,358,349,641,66,16,27.50,25.7
"2011","Easington (County Durham) BUA","E34001750","Total",7193,3555,3638,7108,85,40,156.25,46.0
"2011","Hempnall Green BUA","E34001751","Total",330,159,171,330,0,7,21.00,15.7
"2011","Wood Street Village BUA","E34001752","Total",1619,792,827,1566,53,45,93.50,17.3
"2011","Corston (Bath and North East Somerset) BUA","E34001753","Total",494,222,272,422,72,9,27.25,18.1
"2011","Studland BUA","E34001754","Total",299,151,148,298,1,6,41.00,7.3
"2011","Collingbourne Ducis BUA","E34001755","Total",957,485,472,917,40,20,53.75,17.8
"2011","Bishop Burton BUA","E34001756","Total",696,316,380,397,299,19,57.25,12.2
"2011","Shackleford BUA","E34001757","Total",253,150,103,201,52,7,29.00,8.7
"2011","Downe BUA","E34001758","Total",327,159,168,327,0,6,23.25,14.1
"2011","New Romney BUA","E34001759","Total",9674,4755,4919,9452,222,84,337.75,28.6
"2011","Bishop Middleham BUA","E34001760","Total",1151,542,609,1151,0,18,34.00,33.9
"2011","Thorpe Audlin BUA","E34001761","Total",660,324,336,660,0,8,20.25,32.6
"2011","Withington (County of Herefordshire) BUA","E34001762","Total",1131,561,570,1115,16,12,30.50,37.1
"2011","Guilsborough BUA","E34001763","Total",692,335,357,692,0,19,44.00,15.7
"2011","Old Dalby BUA","E34001764","Total",355,167,188,317,38,14,28.75,12.3
"2011","Toy's Hill BUA","E34001765","Total",339,170,169,339,0,18,23.25,14.6
"2011","Highworth BUA","E34001766","Total",7886,3803,4083,7839,47,102,188.75,41.8
"2011","Bolney BUA","E34001767","Total",591,268,323,591,0,15,42.75,13.8
"2011","Oldhill Wood BUA","E34001768","Total",141,73,68,141,0,0,24.75,5.7
"2011","Wrays BUA","E34001769","Total",307,153,154,299,8,8,29.50,10.4
"2011","Freckenham BUA","E34001770","Total",344,182,162,344,0,6,29.25,11.8
"2011","Sedgefield BUA","E34001771","Total",4456,2191,2265,4449,7,66,128.75,34.6
"2011","Grainthorpe BUA","E34001772","Total",563,278,285,563,0,6,31.00,18.2
"2011","Hook Norton BUA","E34001773","Total",1919,908,1011,1919,0,50,78.75,24.4
"2011","Etchinghill BUA","E34001774","Total",598,284,314,577,21,2,29.50,20.3
"2011","Dunstan Lane, nr Burton BUA","E34001775","Total",153,76,77,153,0,2,22.75,6.7
"2011","Malborough BUA","E34001776","Total",819,382,437,819,0,4,31.00,26.4
"2011","Corse BUA","E34001777","Total",1178,564,614,1176,2,16,74.25,15.9
"2011","Sandford BUA","E34001778","Total",641,304,337,628,13,10,21.25,30.2
"2011","Bean BUA","E34001779","Total",1508,741,767,1508,0,6,31.00,48.6
"2011","Ockley BUA","E34001780","Total",595,293,302,595,0,15,22.50,26.4
"2011","Rock (Cornwall) BUA","E34001781","Total",1203,571,632,1179,24,20,124.25,9.7
"2011","Broughton (Kettering) BUA","E34001782","Total",2208,1070,1138,2208,0,42,63.25,34.9
"2011","Meonstoke BUA","E34001783","Total",833,398,435,833,0,36,66.50,12.5
"2011","Cuffley BUA","E34001784","Total",4282,2097,2185,4282,0,114,206.00,20.8
"2011","Letty Green BUA","E34001785","Total",316,157,159,316,0,18,28.50,11.1
"2011","Griston BUA","E34001786","Total",1540,1190,350,641,899,6,52.25,29.5
"2011","Gedney Dyke BUA","E34001787","Total",320,159,161,320,0,7,23.75,13.5
"2011","Ince Blundell BUA","E34001788","Total",516,237,279,483,33,4,22.75,22.7
"2011","Henley-In-Arden BUA","E34001789","Total",2846,1361,1485,2843,3,54,87.50,32.5
"2011","Brogborough BUA","E34001790","Total",302,158,144,300,2,5,38.50,7.8
"2011","Stalbridge BUA","E34001791","Total",2396,1166,1230,2348,48,31,82.00,29.2
"2011","Wrentham BUA","E34001792","Total",830,401,429,830,0,8,37.25,22.3
"2011","Wendens Ambo BUA","E34001793","Total",473,232,241,473,0,14,43.25,10.9
"2011","Bredon BUA","E34001794","Total",1936,949,987,1936,0,39,73.75,26.3
"2011","Cornforth BUA","E34001795","Total",2501,1238,1263,2467,34,14,75.75,33.0
"2011","Welford-on-Avon BUA","E34001796","Total",1420,677,743,1420,0,35,107.00,13.3
"2011","Coffinswell BUA","E34001797","Total",241,122,119,241,0,13,20.25,11.9
"2011","Dorstone BUA","E34001798","Total",401,189,212,401,0,16,22.25,18.0
"2011","Bourn BUA","E34001799","Total",669,332,337,669,0,16,40.25,16.6
"2011","Shere BUA","E34001800","Total",670,315,355,665,5,14,37.25,18.0
"2011","Great Haywood BUA","E34001801","Total",1844,888,956,1844,0,15,45.50,40.5
"2011","Kineton BUA","E34001802","Total",2014,982,1032,1913,101,36,64.00,31.5
"2011","Abbotsley BUA","E34001803","Total",446,221,225,441,5,8,33.75,13.2
"2011","St Germans BUA","E34001804","Total",493,237,256,493,0,8,33.00,14.9
"2011","Fairfield Park BUA","E34001805","Total",2682,1327,1355,2682,0,22,58.25,46.0
"2011","Colden Common BUA","E34001806","Total",3419,1668,1751,3419,0,63,123.25,27.7
"2011","Washingborough BUA","E34001807","Total",6463,3141,3322,6426,37,69,202.50,31.9
"2011","Fyfield BUA","E34001808","Total",796,398,398,796,0,11,25.00,31.8
"2011","Charfield BUA","E34001809","Total",2370,1191,1179,2369,1,33,76.50,31.0
"2011","Great Eversden BUA","E34001810","Total",241,109,132,241,0,6,25.25,9.5
"2011","Renishaw BUA","E34001811","Total",2434,1231,1203,2434,0,13,57.50,42.3
"2011","Portreath BUA","E34001812","Total",963,471,492,963,0,18,50.50,19.1
"2011","Manfield BUA","E34001813","Total",279,144,135,277,2,11,20.25,13.8
"2011","Essendine BUA","E34001814","Total",448,224,224,448,0,12,29.50,15.2
"2011","Oakhill BUA","E34001815","Total",739,368,371,689,50,10,43.75,16.9
"2011","West Bank BUA","E34001816","Total",107,51,56,107,0,4,51.50,2.1
"2011","Gedney Drove End BUA","E34001817","Total",734,370,364,689,45,5,29.25,25.1
"2011","Horning BUA","E34001818","Total",1098,518,580,1098,0,13,82.00,13.4
"2011","Brockenhurst BUA","E34001819","Total",3552,1686,1866,3363,189,78,183.00,19.4
"2011","Mayland BUA","E34001820","Total",3724,1890,1834,3724,0,41,122.25,30.5
"2011","Arnesby BUA","E34001821","Total",357,164,193,342,15,8,23.50,15.2
"2011","Menheniot BUA","E34001822","Total",782,368,414,782,0,14,26.75,29.2
"2011","Minety BUA","E34001823","Total",854,434,420,854,0,29,46.00,18.6
"2011","Nassington BUA","E34001824","Total",827,418,409,827,0,7,40.00,20.7
"2011","Bradley BUA","E34001825","Total",513,265,248,473,40,7,22.50,22.8
"2011","Rampton (South Cambridgeshire) BUA","E34001826","Total",448,224,224,448,0,5,31.00,14.5
"2011","Wysall BUA","E34001827","Total",431,224,207,431,0,15,21.25,20.3
"2011","Craven Arms BUA","E34001828","Total",2595,1306,1289,2589,6,19,85.75,30.3
"2011","Billy Row BUA","E34001829","Total",1354,638,716,1296,58,7,35.50,38.1
"2011","Wistanswick BUA","E34001830","Total",233,120,113,233,0,0,20.25,11.5
"2011","Cliffe Woods BUA","E34001831","Total",2662,1338,1324,2656,6,27,58.25,45.7
"2011","East Rainton BUA","E34001832","Total",1213,564,649,1213,0,5,33.00,36.8
"2011","Bosham Hoe BUA","E34001833","Total",277,131,146,277,0,10,21.00,13.2
"2011","Meopham (South) BUA","E34001834","Total",1245,589,656,1245,0,28,74.50,16.7
"2011","Hartlip BUA","E34001835","Total",743,363,380,727,16,20,27.25,27.3
"2011","Worlaby BUA","E34001836","Total",547,282,265,547,0,14,33.25,16.5
"2011","Cranwell (North West) BUA","E34001837","Total",433,222,211,433,0,17,29.75,14.6
"2011","Branton BUA","E34001838","Total",1992,967,1025,1992,0,31,65.75,30.3
"2011","Dummer BUA","E34001839","Total",466,228,238,464,2,17,27.75,16.8
"2011","Little Brickhill BUA","E34001840","Total",407,206,201,407,0,8,23.50,17.3
"2011","Ansty BUA","E34001841","Total",332,171,161,332,0,5,23.25,14.3
"2011","Burton upon Stather BUA","E34001842","Total",2410,1216,1194,2410,0,31,95.50,25.2
"2011","Market Overton BUA","E34001843","Total",584,280,304,551,33,17,24.50,23.8
"2011","Chevington BUA","E34001844","Total",301,141,160,301,0,7,23.00,13.1
"2011","Heather BUA","E34001845","Total",920,470,450,920,0,4,29.50,31.2
"2011","Saxtead Green BUA","E34001846","Total",335,157,178,277,58,8,21.00,16.0
"2011","Cargo BUA","E34001847","Total",500,266,234,500,0,3,21.50,23.3
"2011","Romsley BUA","E34001848","Total",1360,690,670,1321,39,21,70.00,19.4
"2011","Whitchurch Canonicorum BUA","E34001849","Total",312,151,161,312,0,9,20.50,15.2
"2011","South Ockendon BUA","E34001850","Total",19460,9634,9826,19402,58,121,377.25,51.6
"2011","Axmouth BUA","E34001851","Total",496,234,262,496,0,5,20.75,23.9
"2011","Royal Hospital School BUA","E34001852","Total",837,452,385,333,504,45,27.50,30.4
"2011","Brimfield BUA","E34001853","Total",751,361,390,751,0,12,47.75,15.7
"2011","South Chailey BUA","E34001854","Total",1021,477,544,1015,6,26,35.25,29.0
"2011","Sole Street BUA","E34001855","Total",977,496,481,977,0,22,45.75,21.4
"2011","Lower Hardres BUA","E34001856","Total",269,133,136,269,0,5,29.00,9.3
"2011","Furneux Pelham BUA","E34001857","Total",553,277,276,553,0,17,21.50,25.7
"2011","Rothersthorpe BUA","E34001858","Total",472,227,245,472,0,11,22.75,20.7
"2011","Ickford BUA","E34001859","Total",680,350,330,680,0,17,37.00,18.4
"2011","Upper Gravenhurst BUA","E34001860","Total",595,291,304,595,0,12,31.75,18.7
"2011","Newnham (Forest of Dean) BUA","E34001861","Total",1085,545,540,1074,11,21,35.25,30.8
"2011","Ettington BUA","E34001862","Total",1039,509,530,1039,0,22,43.00,24.2
"2011","Bream BUA","E34001863","Total",3047,1515,1532,3047,0,29,129.00,23.6
"2011","Tow House BUA","E34001864","Total",762,386,376,743,19,12,22.75,33.5
"2011","Kington St Michael BUA","E34001865","Total",704,347,357,689,15,15,26.50,26.6
"2011","Minsterworth BUA","E34001866","Total",444,205,239,386,58,7,27.75,16.0
"2011","Apperley BUA","E34001867","Total",550,277,273,550,0,15,28.25,19.5
"2011","Denby Dale BUA","E34001868","Total",3043,1524,1519,3021,22,49,108.50,28.0
"2011","Defford BUA","E34001869","Total",571,294,277,571,0,13,21.75,26.3
"2011","Wylye BUA","E34001870","Total",412,201,211,412,0,14,24.00,17.2
"2011","Howle Hill BUA","E34001871","Total",420,212,208,418,2,12,22.25,18.9
"2011","Toft BUA","E34001872","Total",503,238,265,501,2,18,31.25,16.1
"2011","Sambourne BUA","E34001873","Total",232,116,116,232,0,3,26.75,8.7
"2011","Ardingly BUA","E34001874","Total",1250,632,618,1250,0,21,57.75,21.6
"2011","North Frodingham BUA","E34001875","Total",830,413,417,830,0,15,36.00,23.1
"2011","Hamble-le-Rice BUA","E34001876","Total",4695,2375,2320,4695,0,38,161.50,29.1
"2011","Eastleach Martin BUA","E34001877","Total",306,144,162,306,0,16,25.00,12.2
"2011","Halland BUA","E34001878","Total",369,181,188,339,30,6,35.50,10.4
"2011","Little Haywood BUA","E34001879","Total",2067,1015,1052,2060,7,43,64.50,32.0
"2011","Breighton BUA","E34001880","Total",271,132,139,271,0,7,25.75,10.5
"2011","Chipping Norton BUA","E34001881","Total",5719,2751,2968,5690,29,73,146.00,39.2
"2011","Eardisley BUA","E34001882","Total",550,269,281,548,2,10,43.25,12.7
"2011","Ancaster BUA","E34001883","Total",1294,630,664,1294,0,17,57.50,22.5
"2011","Rolvenden Layne BUA","E34001884","Total",362,170,192,362,0,14,23.00,15.7
"2011","Sarratt BUA","E34001885","Total",918,433,485,918,0,19,73.25,12.5
"2011","Tyler Hill BUA","E34001886","Total",587,282,305,587,0,12,27.75,21.2
"2011","Denton (South Kesteven) BUA","E34001887","Total",273,133,140,273,0,5,25.25,10.8
"2011","Barrow Hill BUA","E34001888","Total",336,171,165,305,31,4,30.75,10.9
"2011","Beeston BUA","E34001889","Total",566,290,276,566,0,8,29.75,19.0
"2011","Maidwell BUA","E34001890","Total",429,253,176,330,99,16,25.75,16.7
"2011","Grange Moor BUA","E34001891","Total",1126,523,603,1126,0,17,34.00,33.1
"2011","Upper Longdon BUA","E34001892","Total",324,165,159,324,0,10,29.25,11.1
"2011","Bempton BUA","E34001893","Total",1040,499,541,1027,13,17,34.50,30.1
"2011","Elswick BUA","E34001894","Total",1079,521,558,1079,0,25,29.50,36.6
"2011","West Chiltington Common BUA","E34001895","Total",7474,3574,3900,7397,77,172,500.25,14.9
"2011","New Rossington BUA","E34001896","Total",13537,6543,6994,13354,183,83,321.50,42.1
"2011","Kingston near Lewes BUA","E34001897","Total",831,385,446,816,15,28,57.50,14.5
"2011","Stourton BUA","E34001898","Total",541,255,286,541,0,8,34.50,15.7
"2011","Countess BUA","E34001899","Total",301,139,162,292,9,8,22.25,13.5
"2011","Stoke Hammond BUA","E34001900","Total",875,427,448,858,17,20,39.25,22.3
"2011","Seagrave BUA","E34001901","Total",546,267,279,544,2,8,35.25,15.5
"2011","Swillington BUA","E34001902","Total",3088,1500,1588,3088,0,17,87.50,35.3
"2011","Coxheath BUA","E34001903","Total",4082,2004,2078,4053,29,45,90.00,45.4
"2011","Tipton St John BUA","E34001904","Total",644,310,334,644,0,17,29.50,21.8
"2011","Lympstone BUA","E34001905","Total",1763,855,908,1753,10,43,80.50,21.9
"2011","Mawsley Village BUA","E34001906","Total",2320,1114,1206,2320,0,24,51.00,45.5
"2011","Holywell Green BUA","E34001907","Total",3178,1519,1659,3178,0,31,76.75,41.4
"2011","Cockshutt BUA","E34001908","Total",787,403,384,787,0,19,24.50,32.1
"2011","Erpingham BUA","E34001909","Total",378,193,185,378,0,8,21.75,17.4
"2011","Milton Malsor BUA","E34001910","Total",761,359,402,737,24,10,37.00,20.6
"2011","Corston (Wiltshire) BUA","E34001911","Total",275,138,137,275,0,5,26.00,10.6
"2011","Standlake BUA","E34001912","Total",1149,562,587,1069,80,32,68.50,16.8
"2011","Garvestone BUA","E34001913","Total",332,161,171,332,0,10,23.75,14.0
"2011","Belton (Great Yarmouth) BUA","E34001914","Total",4520,2248,2272,4520,0,45,196.00,23.1
"2011","Kemerton BUA","E34001915","Total",379,176,203,379,0,9,38.00,10.0
"2011","Meldreth BUA","E34001916","Total",1783,857,926,1678,105,36,94.50,18.9
"2011","Tollerton (Hambleton) BUA","E34001917","Total",1026,517,509,1023,3,31,33.75,30.4
"2011","Timsbury BUA","E34001918","Total",2504,1226,1278,2435,69,28,79.00,31.7
"2011","Ixworth BUA","E34001919","Total",2365,1138,1227,2278,87,43,75.00,31.5
"2011","Purton BUA","E34001920","Total",3554,1700,1854,3467,87,66,130.50,27.2
"2011","Christow BUA","E34001921","Total",820,397,423,816,4,20,34.50,23.8
"2011","Moretonhampstead BUA","E34001922","Total",1339,644,695,1294,45,29,56.25,23.8
"2011","Ashover BUA","E34001923","Total",659,306,353,641,18,17,42.00,15.7
"2011","Chilton (Vale of White Horse) BUA","E34001924","Total",894,449,445,889,5,27,32.25,27.7
"2011","Boughton Lees BUA","E34001925","Total",395,189,206,395,0,4,23.50,16.8
"2011","Birdingbury BUA","E34001926","Total",362,181,181,362,0,6,22.00,16.5
"2011","Croft (Warrington) BUA","E34001927","Total",1492,699,793,1492,0,28,54.50,27.4
"2011","Puttenham BUA","E34001928","Total",601,283,318,574,27,22,39.00,15.4
"2011","Stokenham BUA","E34001929","Total",362,171,191,362,0,6,23.00,15.7
"2011","Wheaton Aston BUA","E34001930","Total",1965,968,997,1965,0,23,50.50,38.9
"2011","Chrishall BUA","E34001931","Total",322,148,174,322,0,17,23.00,14.0
"2011","Long Lawford BUA","E34001932","Total",3007,1495,1512,3004,3,41,82.25,36.6
"2011","Wrawby BUA","E34001933","Total",1469,744,725,1455,14,26,73.50,20.0
"2011","Great Ryburgh BUA","E34001934","Total",694,364,330,694,0,12,38.00,18.3
"2011","Hatherleigh BUA","E34001935","Total",1518,727,791,1450,68,21,57.75,26.3
"2011","Culham BUA","E34001936","Total",453,228,225,453,0,14,27.00,16.8
"2011","Thornwood Common BUA","E34001937","Total",969,450,519,947,22,10,36.25,26.7
"2011","Stoke Row BUA","E34001938","Total",651,316,335,649,2,26,55.75,11.7
"2011","Epperstone BUA","E34001939","Total",589,281,308,589,0,13,34.75,16.9
"2011","Brightlingsea BUA","E34001940","Total",8076,3937,4139,7989,87,75,215.25,37.5
"2011","Ridgmont BUA","E34001941","Total",411,204,207,409,2,17,25.25,16.3
"2011","Cropston BUA","E34001942","Total",1197,583,614,1166,31,27,55.25,21.7
"2011","Mumby BUA","E34001943","Total",447,217,230,447,0,3,23.00,19.4
"2011","Ashwellthorpe BUA","E34001944","Total",454,221,233,454,0,10,40.50,11.2
"2011","West Butterwick BUA","E34001945","Total",795,398,397,795,0,3,39.00,20.4
"2011","Hinton St Mary BUA","E34001946","Total",240,121,119,240,0,2,22.00,10.9
"2011","Stone Hill BUA","E34001947","Total",392,187,205,392,0,6,29.25,13.4
"2011","Wighton BUA","E34001948","Total",222,109,113,220,2,4,22.00,10.1
"2011","Chaldon BUA","E34001949","Total",678,326,352,618,60,18,59.00,11.5
"2011","Clun BUA","E34001950","Total",680,331,349,680,0,13,38.75,17.5
"2011","Cassington BUA","E34001951","Total",750,371,379,723,27,17,37.75,19.9
"2011","Ebberston BUA","E34001952","Total",459,225,234,459,0,18,25.75,17.8
"2011","Capenhurst BUA","E34001953","Total",380,177,203,355,25,1,104.00,3.7
"2011","St Mary Bourne BUA","E34001954","Total",671,337,334,669,2,17,45.50,14.7
"2011","Medbourne BUA","E34001955","Total",473,231,242,472,1,16,34.75,13.6
"2011","Maple Cross BUA","E34001956","Total",2427,1158,1269,2427,0,31,58.75,41.3
"2011","Wilcott BUA","E34001957","Total",228,110,118,228,0,9,27.75,8.2
"2011","Stanford-le-Hope BUA","E34001958","Total",28725,13975,14750,28649,76,265,581.25,49.4
"2011","Rookley BUA","E34001959","Total",638,306,332,635,3,9,32.75,19.5
"2011","Newton (Fenland) BUA","E34001960","Total",310,165,145,301,9,5,22.50,13.8
"2011","Claverdon BUA","E34001961","Total",848,402,446,848,0,30,47.75,17.8
"2011","Yeovil BUA","E34001962","Total",45784,22525,23259,45090,694,580,1256.50,36.4
"2011","Bolton BUA","E34001963","Total",435,235,200,392,43,7,28.50,15.3
"2011","Hatton BUA","E34001964","Total",2020,994,1026,2020,0,27,47.25,42.8
"2011","Swainby BUA","E34001965","Total",597,294,303,597,0,18,32.75,18.2
"2011","North Baddesley BUA","E34001966","Total",6823,3309,3514,6773,50,65,157.75,43.3
"2011","Brinkley BUA","E34001967","Total",391,197,194,391,0,7,24.50,16.0
"2011","Worlington BUA","E34001968","Total",526,258,268,526,0,5,38.50,13.7
"2011","Mundesley BUA","E34001969","Total",2758,1269,1489,2693,65,37,129.25,21.3
"2011","Marston Moretaine BUA","E34001970","Total",3850,1895,1955,3788,62,24,88.00,43.8
"2011","Easton Royal BUA","E34001971","Total",253,120,133,253,0,14,28.50,8.9
"2011","Pudsey Hall Lane, nr Rochford BUA","E34001972","Total",401,208,193,401,0,0,33.00,12.2
"2011","Harrietsham BUA","E34001973","Total",1442,724,718,1400,42,17,129.75,11.1
"2011","Semington BUA","E34001974","Total",786,395,391,775,11,8,33.00,23.8
"2011","Somersham (Mid Suffolk) BUA","E34001975","Total",733,366,367,733,0,9,29.50,24.8
"2011","Brantham BUA","E34001976","Total",2344,1160,1184,2344,0,33,115.00,20.4
"2011","Morchard Bishop BUA","E34001977","Total",1078,515,563,1066,12,7,29.25,36.9
"2011","Binfield Heath BUA","E34001978","Total",709,351,358,709,0,23,36.75,19.3
"2011","Harpole BUA","E34001979","Total",1344,656,688,1344,0,13,50.25,26.7
"2011","Dodford BUA","E34001980","Total",236,116,120,236,0,1,86.75,2.7
"2011","Wisborough Green BUA","E34001981","Total",843,404,439,843,0,18,54.25,15.5
"2011","Amesbury BUA","E34001982","Total",10116,4968,5148,10001,115,136,499.00,20.3
"2011","Baltonsborough BUA","E34001983","Total",523,243,280,523,0,12,31.25,16.7
"2011","Bassingbourn BUA","E34001984","Total",2481,1204,1277,2472,9,54,89.50,27.7
"2011","Seghill BUA","E34001985","Total",2990,1472,1518,2990,0,17,73.25,40.8
"2011","Wrea Green BUA","E34001986","Total",1373,655,718,1373,0,40,60.50,22.7
"2011","Ferriby High Road, nr North Ferriby BUA","E34001987","Total",263,133,130,263,0,7,31.75,8.3
"2011","Braithwell BUA","E34001988","Total",804,386,418,804,0,6,35.75,22.5
"2011","Hawkshaw BUA","E34001989","Total",363,177,186,363,0,9,23.00,15.8
"2011","Scampton Airfield BUA","E34001990","Total",1145,559,586,1144,1,13,234.00,4.9
"2011","Pebworth BUA","E34001991","Total",808,410,398,808,0,26,35.75,22.6
"2011","North Greetwell BUA","E34001992","Total",515,257,258,515,0,4,24.00,21.5
"2011","Crook BUA","E34001993","Total",9498,4598,4900,9431,67,78,253.75,37.4
"2011","Nawton BUA","E34001994","Total",798,391,407,772,26,14,36.25,22.0
"2011","Kingston Lisle BUA","E34001995","Total",225,112,113,217,8,19,20.25,11.1
"2011","Lyminge BUA","E34001996","Total",1948,914,1034,1948,0,43,81.00,24.0
"2011","Walpole Highway BUA","E34001997","Total",701,339,362,683,18,10,29.25,24.0
"2011","East Meon BUA","E34001998","Total",871,422,449,821,50,28,31.75,27.4
"2011","Lambourn BUA","E34001999","Total",3071,1520,1551,3064,7,46,108.50,28.3
"2011","Ruan Minor BUA","E34002000","Total",558,293,265,558,0,8,24.00,23.2
"2011","Napton on the Hill BUA","E34002001","Total",898,436,462,898,0,25,45.50,19.7
"2011","Holmesfield BUA","E34002002","Total",753,369,384,753,0,15,42.75,17.6
"2011","Whatstandwell BUA","E34002003","Total",270,131,139,270,0,6,24.25,11.1
"2011","Longrock BUA","E34002004","Total",570,266,304,553,17,6,42.25,13.5
"2011","Bentley (Babergh) BUA","E34002005","Total",518,259,259,518,0,6,29.00,17.9
"2011","Lower Down BUA","E34002006","Total",329,147,182,264,65,11,32.75,10.0
"2011","Podington BUA","E34002007","Total",435,227,208,394,41,6,22.50,19.3
"2011","East Hanningfield BUA","E34002008","Total",977,467,510,977,0,10,44.50,22.0
"2011","Easton (Suffolk Coastal) BUA","E34002009","Total",331,156,175,331,0,4,22.75,14.5
"2011","Shipston-on-Stour BUA","E34002010","Total",5038,2401,2637,4997,41,82,133.00,37.9
"2011","Mid Lavant BUA","E34002011","Total",1349,625,724,1349,0,16,44.25,30.5
"2011","Drayton Parslow BUA","E34002012","Total",614,299,315,614,0,22,31.00,19.8
"2011","Long Sutton (Hart) BUA","E34002013","Total",234,116,118,234,0,14,26.00,9.0
"2011","Alston BUA","E34002014","Total",1105,524,581,1088,17,17,38.00,29.1
"2011","West Bretton BUA","E34002015","Total",459,227,232,459,0,10,22.00,20.9
"2011","Uley BUA","E34002016","Total",998,499,499,998,0,26,43.50,22.9
"2011","Eynsford BUA","E34002017","Total",2791,1337,1454,2780,11,60,137.25,20.3
"2011","Abbots Leigh BUA","E34002018","Total",641,297,344,586,55,20,62.00,10.3
"2011","Barcombe Cross BUA","E34002019","Total",741,340,401,741,0,13,26.00,28.5
"2011","Mattersey BUA","E34002020","Total",466,244,222,395,71,17,24.50,19.0
"2011","Wangford BUA","E34002021","Total",466,218,248,464,2,2,29.50,15.8
"2011","Waddingham BUA","E34002022","Total",601,294,307,601,0,5,30.25,19.9
"2011","West Bradford BUA","E34002023","Total",548,259,289,548,0,17,21.75,25.2
"2011","Woodhouse Eaves BUA","E34002024","Total",1568,759,809,1568,0,36,68.25,23.0
"2011","Kingfisher Court BUA","E34002025","Total",550,266,284,550,0,11,44.25,12.4
"2011","Great Somerford BUA","E34002026","Total",593,292,301,593,0,15,42.00,14.1
"2011","Soberton Heath BUA","E34002027","Total",324,159,165,324,0,12,25.00,13.0
"2011","Gotherington BUA","E34002028","Total",995,485,510,995,0,27,43.50,22.9
"2011","Oulton BUA","E34002029","Total",621,276,345,595,26,16,22.00,28.2
"2011","Kelfield BUA","E34002030","Total",497,247,250,428,69,17,22.00,22.6
"2011","Flockton BUA","E34002031","Total",1368,679,689,1368,0,15,48.00,28.5
"2011","East Harling BUA","E34002032","Total",2142,1040,1102,2105,37,24,77.50,27.6
"2011","Aylesham BUA","E34002033","Total",3793,1822,1971,3793,0,17,90.50,41.9
"2011","Newton (Bolsover) BUA","E34002034","Total",3164,1548,1616,3099,65,15,88.25,35.9
"2011","Stockton BUA","E34002035","Total",1347,693,654,1347,0,24,39.75,33.9
"2011","Babraham BUA","E34002036","Total",276,126,150,276,0,8,27.00,10.2
"2011","Mendlesham BUA","E34002037","Total",884,428,456,884,0,6,29.75,29.7
"2011","Eydon BUA","E34002038","Total",422,211,211,422,0,17,21.50,19.6
"2011","Granborough BUA","E34002039","Total",545,262,283,545,0,16,28.75,19.0
"2011","Cornholme BUA","E34002040","Total",1690,830,860,1690,0,19,43.00,39.3
"2011","Maldon BUA","E34002041","Total",21462,10424,11038,21222,240,205,516.75,41.5
"2011","Woodhouse BUA","E34002042","Total",215,101,114,215,0,11,20.25,10.6
"2011","Fowlmere BUA","E34002043","Total",1206,605,601,1206,0,29,55.25,21.8
"2011","Istead Rise BUA","E34002044","Total",3437,1698,1739,3437,0,48,90.50,38.0
"2011","Bilsborrow BUA","E34002045","Total",632,322,310,632,0,9,52.25,12.1
"2011","Huggate BUA","E34002046","Total",342,163,179,342,0,9,20.25,16.9
"2011","Bampton (Mid Devon) BUA","E34002047","Total",1260,599,661,1218,42,18,52.75,23.9
"2011","Glasshouses BUA","E34002048","Total",526,248,278,526,0,11,20.25,26.0
"2011","Nayland BUA","E34002049","Total",938,424,514,887,51,29,56.25,16.7
"2011","Peasmarsh (Guildford) BUA","E34002050","Total",528,235,293,420,108,8,21.50,24.6
"2011","North Country BUA","E34002051","Total",773,388,385,773,0,6,21.75,35.5
"2011","Westhope BUA","E34002052","Total",266,129,137,266,0,9,27.00,9.9
"2011","Sudbury BUA","E34002053","Total",22213,10749,11464,21849,364,244,622.75,35.7
"2011","Brandon (County Durham) BUA","E34002054","Total",9566,4643,4923,9486,80,101,305.25,31.3
"2011","Middle Barton BUA","E34002055","Total",1767,838,929,1767,0,27,55.00,32.1
"2011","Yatton Keynell BUA","E34002056","Total",825,413,412,819,6,18,30.00,27.5
"2011","Weston (South Holland) BUA","E34002057","Total",934,448,486,934,0,10,38.00,24.6
"2011","Workhouse End BUA","E34002058","Total",339,168,171,339,0,8,25.25,13.4
"2011","Walgrave BUA","E34002059","Total",868,430,438,868,0,19,36.50,23.8
"2011","Downgate BUA","E34002060","Total",286,150,136,284,2,4,27.75,10.3
"2011","Ormskirk BUA","E34002061","Total",24073,11433,12640,22874,1199,421,669.50,36.0
"2011","Sutton St James BUA","E34002062","Total",953,475,478,953,0,9,58.00,16.4
"2011","West Horndon BUA","E34002063","Total",1537,764,773,1531,6,19,64.50,23.8
"2011","Rickling Green BUA","E34002064","Total",587,294,293,584,3,16,44.25,13.3
"2011","Longtown BUA","E34002065","Total",2050,1043,1007,2026,24,13,60.50,33.9
"2011","Fawley BUA","E34002066","Total",258,125,133,258,0,9,24.50,10.5
"2011","Wrotham Heath BUA","E34002067","Total",241,117,124,241,0,4,35.50,6.8
"2011","Deddington BUA","E34002068","Total",1594,766,828,1568,26,29,56.00,28.5
"2011","Barkston Ash BUA","E34002069","Total",370,176,194,370,0,4,23.50,15.7
"2011","Coldwaltham BUA","E34002070","Total",597,309,288,597,0,11,29.00,20.6
"2011","South Wonston BUA","E34002071","Total",2196,1089,1107,2196,0,57,69.25,31.7
"2011","Moulton (Forest Heath) BUA","E34002072","Total",1033,510,523,1020,13,17,56.75,18.2
"2011","Boxford BUA","E34002073","Total",996,499,497,996,0,15,47.50,21.0
"2011","Blyth (Northumberland) BUA","E34002074","Total",37339,18172,19167,36963,376,182,842.75,44.3
"2011","Norton St Philip BUA","E34002075","Total",556,276,280,555,1,12,39.00,14.3
"2011","Ardleigh BUA","E34002076","Total",912,446,466,896,16,11,38.75,23.5
"2011","Sparsholt BUA","E34002077","Total",417,203,214,417,0,16,37.50,11.1
"2011","Great Cheverell BUA","E34002078","Total",475,239,236,475,0,13,31.00,15.3
"2011","Tibberton (Forest of Dean) BUA","E34002079","Total",565,288,277,565,0,17,33.00,17.1
"2011","Laughton BUA","E34002080","Total",410,208,202,410,0,6,21.50,19.1
"2011","Newbold-on-Stour BUA","E34002081","Total",517,244,273,517,0,23,28.75,18.0
"2011","Four Throws BUA","E34002082","Total",451,239,212,451,0,30,29.00,15.6
"2011","Branston BUA","E34002083","Total",3852,1849,2003,3810,42,52,131.25,29.3
"2011","Sandwich Bay Estate BUA","E34002084","Total",358,187,171,358,0,9,23.75,15.1
"2011","Holbeach BUA","E34002085","Total",7914,3827,4087,7854,60,63,300.00,26.4
"2011","Duxford BUA","E34002086","Total",2099,1009,1090,2099,0,54,94.50,22.2
"2011","Faldingworth BUA","E34002087","Total",400,196,204,400,0,4,26.00,15.4
"2011","Stow cum Quy BUA","E34002088","Total",544,268,276,544,0,8,29.25,18.6
"2011","Higher Wheelton BUA","E34002089","Total",658,315,343,658,0,21,48.50,13.6
"2011","Coates (Fenland) BUA","E34002090","Total",2117,1053,1064,2117,0,25,74.25,28.5
"2011","Dodleston BUA","E34002091","Total",715,363,352,715,0,7,24.75,28.9
"2011","Haydon Bridge BUA","E34002092","Total",1557,754,803,1527,30,25,56.75,27.4
"2011","Martham BUA","E34002093","Total",3405,1648,1757,3369,36,34,118.50,28.7
"2011","Hodnet BUA","E34002094","Total",292,142,150,288,4,5,22.75,12.8
"2011","Cann Common BUA","E34002095","Total",270,120,150,270,0,5,22.50,12.0
"2011","East End BUA","E34002096","Total",216,110,106,216,0,4,20.50,10.5
"2011","Helmdon BUA","E34002097","Total",761,370,391,761,0,13,35.00,21.7
"2011","Brigham BUA","E34002098","Total",756,376,380,756,0,14,27.50,27.5
"2011","Clipston BUA","E34002099","Total",643,316,327,643,0,22,34.25,18.8
"2011","Great Ponton BUA","E34002100","Total",379,185,194,379,0,6,20.50,18.5
"2011","South Grove BUA","E34002101","Total",199,96,103,199,0,6,56.25,3.5
"2011","Shap BUA","E34002102","Total",1264,639,625,1258,6,18,45.50,27.8
"2011","Burford BUA","E34002103","Total",1184,559,625,1112,72,12,76.50,15.5
"2011","Sherston BUA","E34002104","Total",1449,691,758,1449,0,37,53.75,27.0
"2011","East Horsley BUA","E34002105","Total",5866,2838,3028,5801,65,245,403.50,14.5
"2011","Icklesham BUA","E34002106","Total",941,455,486,941,0,12,42.25,22.3
"2011","Soulbury BUA","E34002107","Total",294,146,148,294,0,4,26.00,11.3
"2011","Ticknall BUA","E34002108","Total",642,313,329,642,0,13,40.25,16.0
"2011","Christ's Hospital BUA","E34002109","Total",1382,675,707,604,778,60,39.25,35.2
"2011","Charlton (Wychavon) BUA","E34002110","Total",592,286,306,592,0,7,22.00,26.9
"2011","Callow End BUA","E34002111","Total",779,372,407,779,0,4,43.00,18.1
"2011","Burton BUA","E34002112","Total",541,246,295,541,0,17,62.25,8.7
"2011","Bradford-on-Tone BUA","E34002113","Total",622,308,314,622,0,13,22.75,27.3
"2011","Gander's Green BUA","E34002114","Total",178,88,90,178,0,2,56.75,3.1
"2011","North Lopham BUA","E34002115","Total",623,318,305,623,0,7,43.00,14.5
"2011","Heywood BUA","E34002116","Total",452,218,234,452,0,9,28.00,16.1
"2011","Alconbury Weston BUA","E34002117","Total",800,390,410,776,24,13,34.75,23.0
"2011","Diseworth BUA","E34002118","Total",636,317,319,636,0,16,33.75,18.8
"2011","Barlaston BUA","E34002119","Total",1979,947,1032,1887,92,23,94.25,21.0
"2011","St Helens BUA","E34002120","Total",1213,563,650,1213,0,12,59.00,20.6
"2011","Horsleys Green BUA","E34002121","Total",825,422,403,809,16,18,34.75,23.7
"2011","St Neot BUA","E34002122","Total",304,135,169,304,0,3,23.75,12.8
"2011","Gretton (Corby) BUA","E34002123","Total",1285,636,649,1264,21,22,55.00,23.4
"2011","Codford St Peter BUA","E34002124","Total",870,411,459,870,0,25,52.00,16.7
"2011","Burwell BUA","E34002125","Total",6309,3084,3225,6296,13,100,212.75,29.7
"2011","Longhope BUA","E34002126","Total",1092,520,572,1024,68,15,67.50,16.2
"2011","Tremar BUA","E34002127","Total",653,325,328,653,0,11,29.75,21.9
"2011","East Chinnock BUA","E34002128","Total",479,233,246,477,2,9,24.50,19.6
"2011","Acton Trussell BUA","E34002129","Total",786,401,385,786,0,9,33.50,23.5
"2011","Orcheston BUA","E34002130","Total",339,174,165,279,60,7,21.25,16.0
"2011","Kirkby Malzeard BUA","E34002131","Total",887,429,458,887,0,13,28.50,31.1
"2011","Black Notley BUA","E34002132","Total",1988,1004,984,1988,0,30,43.50,45.7
"2011","Nailstone BUA","E34002133","Total",514,262,252,514,0,9,22.50,22.8
"2011","Corscombe BUA","E34002134","Total",445,226,219,445,0,18,20.50,21.7
"2011","Wootton (North Lincolnshire) BUA","E34002135","Total",475,236,239,475,0,9,32.50,14.6
"2011","Ringstead BUA","E34002136","Total",1461,738,723,1415,46,20,47.75,30.6
"2011","Yealmpton BUA","E34002137","Total",1677,773,904,1659,18,36,74.50,22.5
"2011","Mareham le Fen BUA","E34002138","Total",944,467,477,944,0,9,41.75,22.6
"2011","Compton End BUA","E34002139","Total",406,205,201,393,13,8,21.00,19.3
"2011","Eton Wick BUA","E34002140","Total",2029,978,1051,2029,0,23,42.50,47.7
"2011","Darlington BUA","E34002141","Total",92363,45026,47337,91122,1241,1010,2255.25,41.0
"2011","Eastrington BUA","E34002142","Total",1147,553,594,1147,0,7,27.00,42.5
"2011","Kessingland BUA","E34002143","Total",4327,2097,2230,4305,22,42,138.75,31.2
"2011","Lawns Wood BUA","E34002144","Total",361,177,184,361,0,7,21.25,17.0
"2011","Stoke Fleming BUA","E34002145","Total",803,383,420,803,0,6,34.25,23.4
"2011","Bramdean BUA","E34002146","Total",266,129,137,266,0,20,30.50,8.7
"2011","Bere Ferrers BUA","E34002147","Total",446,235,211,420,26,7,20.75,21.5
"2011","Drinkstone Green BUA","E34002148","Total",548,265,283,548,0,16,28.25,19.4
"2011","Witnesham BUA","E34002149","Total",309,147,162,284,25,11,21.25,14.5
"2011","Stanton Harcourt BUA","E34002150","Total",618,298,320,618,0,28,45.00,13.7
"2011","Worth Matravers BUA","E34002151","Total",275,139,136,275,0,13,20.50,13.4
"2011","Hopton on Sea BUA","E34002152","Total",2626,1289,1337,2608,18,26,76.00,34.6
"2011","Fort Halstead BUA","E34002153","Total",386,194,192,386,0,6,48.25,8.0
"2011","Whitminster BUA","E34002154","Total",881,445,436,881,0,9,32.50,27.1
"2011","Crowle (Wychavon) BUA","E34002155","Total",1081,547,534,1081,0,30,30.00,36.0
"2011","Dundry BUA","E34002156","Total",269,135,134,269,0,7,26.75,10.1
"2011","Gayton (South Northamptonshire) BUA","E34002157","Total",544,266,278,502,42,13,30.00,18.1
"2011","Kelloe BUA","E34002158","Total",1502,735,767,1490,12,10,39.25,38.3
"2011","Wardington BUA","E34002159","Total",602,292,310,554,48,15,35.00,17.2
"2011","Axminster BUA","E34002160","Total",5761,2723,3038,5655,106,50,181.00,31.8
"2011","Looe BUA","E34002161","Total",5112,2482,2630,5056,56,52,175.50,29.1
"2011","Long Sutton (South Somerset) BUA","E34002162","Total",464,217,247,461,3,9,56.25,8.2
"2011","Horringer BUA","E34002163","Total",780,393,387,780,0,17,39.25,19.9
"2011","Southwater BUA","E34002164","Total",8692,4369,4323,8692,0,161,238.75,36.4
"2011","Raymond's Hill BUA","E34002165","Total",768,389,379,758,10,17,70.25,10.9
"2011","Audlem BUA","E34002166","Total",1658,791,867,1579,79,16,75.25,22.0
"2011","Ash (South Somerset) BUA","E34002167","Total",626,312,314,623,3,11,32.00,19.6
"2011","St Mabyn BUA","E34002168","Total",277,141,136,277,0,5,23.25,11.9
"2011","Clifford's Mesne BUA","E34002169","Total",373,185,188,373,0,4,34.25,10.9
"2011","Burwash BUA","E34002170","Total",1317,629,688,1317,0,19,69.00,19.1
"2011","Tockington BUA","E34002171","Total",404,202,202,396,8,13,21.00,19.2
"2011","Cranfield BUA","E34002172","Total",5369,2897,2472,4816,553,82,237.00,22.7
"2011","Pytchley BUA","E34002173","Total",489,238,251,489,0,11,28.25,17.3
"2011","Culford BUA","E34002174","Total",578,299,279,412,166,17,32.00,18.1
"2011","Shoreham BUA","E34002175","Total",800,399,401,800,0,18,30.50,26.2
"2011","Norton Canes BUA","E34002176","Total",7479,3696,3783,7473,6,45,199.25,37.5
"2011","Walesby (West Lindsey) BUA","E34002177","Total",249,124,125,249,0,8,21.25,11.7
"2011","Chipperfield (Three Rivers) BUA","E34002178","Total",292,142,150,292,0,13,30.50,9.6
"2011","Ouston BUA","E34002179","Total",379,259,120,213,166,3,66.50,5.7
"2011","Newquay BUA","E34002180","Total",20189,9892,10297,19624,565,210,556.25,36.3
"2011","Burton-in-Kendal BUA","E34002181","Total",1349,669,680,1347,2,33,48.75,27.7
"2011","Hemsworth BUA","E34002182","Total",9246,4532,4714,9223,23,47,241.00,38.4
"2011","Plaw Hatch Lane, nr Sharpthorne BUA","E34002183","Total",357,185,172,357,0,24,20.25,17.6
"2011","Dunton Bassett BUA","E34002184","Total",759,379,380,759,0,15,29.00,26.2
"2011","Higham BUA","E34002185","Total",778,372,406,778,0,16,23.75,32.8
"2011","Clare BUA","E34002186","Total",2028,954,1074,2015,13,36,98.50,20.6
"2011","Gazeley BUA","E34002187","Total",686,347,339,686,0,7,32.25,21.3
"2011","Yetminster BUA","E34002188","Total",1105,528,577,1105,0,22,52.25,21.1
"2011","Thorney Island BUA","E34002189","Total",1183,743,440,782,401,17,99.00,11.9
"2011","Huntspill BUA","E34002190","Total",1133,547,586,1125,8,6,39.50,28.7
"2011","Lightwater BUA","E34002191","Total",6791,3307,3484,6756,35,147,198.25,34.3
"2011","Warkworth BUA","E34002192","Total",1346,644,702,1322,24,27,60.50,22.2
"2011","Linton BUA","E34002193","Total",4525,2183,2342,4453,72,79,139.00,32.6
"2011","Larkhill BUA","E34002194","Total",2358,1487,871,1665,693,48,96.25,24.5
"2011","High Pittington BUA","E34002195","Total",1175,572,603,1175,0,16,29.00,40.5
"2011","Mickleton (Cotswold) BUA","E34002196","Total",1676,793,883,1657,19,25,55.00,30.5
"2011","Terrington BUA","E34002197","Total",337,163,174,331,6,11,24.50,13.8
"2011","Owermoigne BUA","E34002198","Total",334,172,162,334,0,8,27.50,12.1
"2011","Bewdley BUA","E34002199","Total",8571,4227,4344,8526,45,148,247.25,34.7
"2011","Southery BUA","E34002200","Total",1161,576,585,1161,0,4,68.00,17.1
"2011","Roughton BUA","E34002201","Total",571,281,290,571,0,10,38.75,14.7
"2011","Sawtry BUA","E34002202","Total",5252,2609,2643,5236,16,64,132.25,39.7
"2011","Sparkford BUA","E34002203","Total",460,224,236,460,0,8,32.00,14.4
"2011","Upper Cumberworth BUA","E34002204","Total",673,327,346,673,0,15,35.75,18.8
"2011","Sabden BUA","E34002205","Total",1422,703,719,1422,0,18,41.75,34.1
"2011","Welton (Daventry) BUA","E34002206","Total",608,298,310,608,0,20,34.50,17.6
"2011","Reedness BUA","E34002207","Total",339,164,175,339,0,4,45.00,7.5
"2011","Newton (Babergh) BUA","E34002208","Total",495,247,248,495,0,5,26.50,18.7
"2011","Cookley BUA","E34002209","Total",1666,798,868,1662,4,19,59.75,27.9
"2011","North Cheriton BUA","E34002210","Total",208,116,92,189,19,8,25.75,8.1
"2011","Kirkby-in-Furness BUA","E34002211","Total",554,264,290,554,0,3,20.25,27.4
"2011","Millom BUA","E34002212","Total",5980,2927,3053,5925,55,49,149.50,40.0
"2011","Pitsford BUA","E34002213","Total",671,305,366,671,0,15,38.25,17.5
"2011","Foxton (South Cambridgeshire) BUA","E34002214","Total",1232,617,615,1232,0,33,57.75,21.3
"2011","Catcott BUA","E34002215","Total",903,421,482,883,20,17,65.50,13.8
"2011","Wookey BUA","E34002216","Total",810,398,412,781,29,11,43.50,18.6
"2011","Lower Dicker BUA","E34002217","Total",405,189,216,405,0,4,40.00,10.1
"2011","Chieveley BUA","E34002218","Total",987,518,469,982,5,34,59.75,16.5
"2011","Cocking BUA","E34002219","Total",420,204,216,420,0,10,23.25,18.1
"2011","Exminster BUA","E34002220","Total",3368,1617,1751,3314,54,45,82.75,40.7
"2011","Pluckley Thorne BUA","E34002221","Total",669,327,342,669,0,13,74.25,9.0
"2011","Newborough (City of Peterborough) BUA","E34002222","Total",1306,660,646,1299,7,18,41.75,31.3
"2011","Lockington BUA","E34002223","Total",374,180,194,374,0,8,41.50,9.0
"2011","Tolleshunt Knights BUA","E34002224","Total",1030,500,530,980,50,15,71.25,14.5
"2011","Gilberdyke BUA","E34002225","Total",3430,1652,1778,3394,36,27,109.25,31.4
"2011","Denholme BUA","E34002226","Total",2715,1323,1392,2715,0,26,65.00,41.8
"2011","Assington BUA","E34002227","Total",402,196,206,395,7,14,26.75,15.0
"2011","Carlton (Hinckley and Bosworth) BUA","E34002228","Total",305,163,142,305,0,15,26.50,11.5
"2011","Thorpe on the Hill BUA","E34002229","Total",431,211,220,431,0,3,29.00,14.9
"2011","Gainford BUA","E34002230","Total",1133,550,583,1133,0,13,37.75,30.0
"2011","Great Massingham BUA","E34002231","Total",902,445,457,902,0,13,54.50,16.6
"2011","Low Etherley BUA","E34002232","Total",1929,930,999,1875,54,24,73.75,26.2
"2011","Tintagel BUA","E34002233","Total",1028,488,540,968,60,4,58.00,17.7
"2011","Gowdall BUA","E34002234","Total",356,190,166,356,0,9,25.25,14.1
"2011","Nether Stowey BUA","E34002235","Total",1373,634,739,1371,2,22,45.25,30.3
"2011","Litcham BUA","E34002236","Total",439,212,227,437,2,10,26.00,16.9
"2011","Crantock BUA","E34002237","Total",801,384,417,787,14,14,30.50,26.3
"2011","Fairlands BUA","E34002238","Total",1412,693,719,1412,0,13,40.50,34.9
"2011","Crawley (Winchester) BUA","E34002239","Total",296,136,160,296,0,10,41.00,7.2
"2011","Osbournby BUA","E34002240","Total",398,204,194,396,2,3,25.25,15.8
"2011","Porlock BUA","E34002241","Total",1213,563,650,1178,35,9,77.00,15.8
"2011","Brandesburton BUA","E34002242","Total",1291,639,652,1267,24,17,55.25,23.4
"2011","Lackford BUA","E34002243","Total",255,131,124,255,0,6,25.75,9.9
"2011","Chilton Polden BUA","E34002244","Total",698,346,352,698,0,18,34.50,20.2
"2011","Bicker BUA","E34002245","Total",727,360,367,727,0,9,54.75,13.3
"2011","Lower Stanton St Quintin BUA","E34002246","Total",627,406,221,396,231,12,58.00,10.8
"2011","Seething BUA","E34002247","Total",365,179,186,365,0,7,26.50,13.8
"2011","Thornhill BUA","E34002248","Total",915,447,468,915,0,2,26.00,35.2
"2011","Denbury BUA","E34002249","Total",686,353,333,642,44,13,22.50,30.5
"2011","Brampton (Carlisle) BUA","E34002250","Total",4229,2015,2214,4167,62,35,167.50,25.2
"2011","Wiveliscombe BUA","E34002251","Total",2178,1037,1141,2113,65,31,85.25,25.5
"2011","Essendon BUA","E34002252","Total",580,282,298,580,0,18,26.50,21.9
"2011","North Thoresby BUA","E34002253","Total",1068,508,560,1068,0,16,57.75,18.5
"2011","Thirsk BUA","E34002254","Total",9953,4827,5126,9852,101,122,284.75,35.0
"2011","Allonby BUA","E34002255","Total",444,218,226,444,0,10,22.75,19.5
"2011","Westleton BUA","E34002256","Total",349,164,185,349,0,5,40.25,8.7
"2011","Huntingdon BUA","E34002257","Total",23937,11832,12105,23686,251,227,718.75,33.3
"2011","Thorney BUA","E34002258","Total",1745,822,923,1745,0,12,66.50,26.2
"2011","Hopton BUA","E34002259","Total",653,309,344,653,0,6,45.75,14.3
"2011","Evenley BUA","E34002260","Total",571,273,298,571,0,22,32.50,17.6
"2011","Little Hallingbury BUA","E34002261","Total",1352,659,693,1342,10,25,89.75,15.1
"2011","Great Waldingfield BUA","E34002262","Total",1256,614,642,1256,0,27,44.50,28.2
"2011","North Coates Airfield BUA","E34002263","Total",469,228,241,391,78,13,28.75,16.3
"2011","Peasmarsh (Rother) BUA","E34002264","Total",1054,510,544,1053,1,13,60.25,17.5
"2011","Gretton (Tewkesbury) BUA","E34002265","Total",443,228,215,443,0,9,32.50,13.6
"2011","Oldbury-on-Severn BUA","E34002266","Total",347,169,178,347,0,13,31.50,11.0
"2011","Darley BUA","E34002267","Total",783,368,415,782,1,10,43.75,17.9
"2011","Anwick BUA","E34002268","Total",392,206,186,369,23,1,36.25,10.8
"2011","Camelford BUA","E34002269","Total",2335,1115,1220,2313,22,24,83.00,28.1
"2011","Dry Drayton BUA","E34002270","Total",643,308,335,643,0,14,36.75,17.5
"2011","Shapwick BUA","E34002271","Total",536,272,264,466,70,14,25.00,21.4
"2011","Broadwell (Cotswold) BUA","E34002272","Total",355,165,190,355,0,16,23.75,14.9
"2011","Blandford Camp BUA","E34002273","Total",2205,1395,810,1475,730,43,66.25,33.3
"2011","Aldford BUA","E34002274","Total",272,131,141,272,0,7,22.00,12.4
"2011","Dagnall BUA","E34002275","Total",358,177,181,358,0,5,23.25,15.4
"2011","Great Houghton (Northampton) BUA","E34002276","Total",642,313,329,642,0,13,30.50,21.0
"2011","Newton (South Cambridgeshire) BUA","E34002277","Total",378,185,193,378,0,7,24.25,15.6
"2011","Cogenhoe BUA","E34002278","Total",1436,718,718,1436,0,25,53.25,27.0
"2011","Warmington (Stratford-on-Avon) BUA","E34002279","Total",304,150,154,303,1,6,22.00,13.8
"2011","Great Limber BUA","E34002280","Total",271,133,138,241,30,4,22.50,12.0
"2011","Sydling St Nicholas BUA","E34002281","Total",414,194,220,414,0,12,27.00,15.3
"2011","Southfields BUA","E34002282","Total",1118,551,567,1118,0,23,23.75,47.1
"2011","Thorpe Willoughby BUA","E34002283","Total",2725,1366,1359,2725,0,35,67.50,40.4
"2011","Wickwar BUA","E34002284","Total",1717,808,909,1665,52,47,65.00,26.4
"2011","Shirebrook BUA","E34002285","Total",10885,5279,5606,10789,96,44,288.00,37.8
"2011","Whiteparish BUA","E34002286","Total",1130,553,577,1130,0,40,71.00,15.9
"2011","Upper Lambourn BUA","E34002287","Total",381,206,175,353,28,24,27.25,14.0
"2011","Rotherwick BUA","E34002288","Total",564,282,282,522,42,28,25.75,21.9
"2011","Bramshall BUA","E34002289","Total",656,321,335,629,27,16,35.75,18.3
"2011","Chattenden BUA","E34002290","Total",972,484,488,972,0,4,48.75,19.9
"2011","Belford BUA","E34002291","Total",1258,621,637,1258,0,20,46.00,27.3
"2011","Blackdown BUA","E34002292","Total",129,64,65,113,16,6,23.00,5.6
"2011","Akeley BUA","E34002293","Total",514,273,241,514,0,12,32.25,15.9
"2011","Eggborough BUA","E34002294","Total",1952,971,981,1952,0,24,65.50,29.8
"2011","Scarcliffe BUA","E34002295","Total",442,222,220,442,0,9,23.75,18.6
"2011","South Newington BUA","E34002296","Total",285,141,144,282,3,12,21.00,13.6
"2011","Whissendine BUA","E34002297","Total",1253,610,643,1253,0,46,58.25,21.5
"2011","Ingoldsby BUA","E34002298","Total",284,139,145,284,0,11,21.75,13.1
"2011","East Bridgford BUA","E34002299","Total",1814,860,954,1797,17,44,78.75,23.0
"2011","Bishops Lydeard BUA","E34002300","Total",2040,959,1081,2040,0,32,61.75,33.0
"2011","Clifton (Derbyshire Dales) BUA","E34002301","Total",297,143,154,297,0,7,20.50,14.5
"2011","Saughall BUA","E34002302","Total",2569,1262,1307,2569,0,40,79.50,32.3
"2011","Cowling BUA","E34002303","Total",1350,661,689,1340,10,15,25.75,52.4
"2011","Lidgate BUA","E34002304","Total",241,113,128,241,0,3,24.75,9.7
"2011","Easingwold BUA","E34002305","Total",4358,1981,2377,4340,18,95,149.25,29.2
"2011","Prees Higher Heath BUA","E34002306","Total",1163,578,585,1163,0,17,71.75,16.2
"2011","Pimperne BUA","E34002307","Total",1109,543,566,1109,0,25,41.50,26.7
"2011","Great Haseley BUA","E34002308","Total",511,244,267,511,0,10,25.25,20.2
"2011","Lynton BUA","E34002309","Total",1157,552,605,1026,131,11,57.00,20.3
"2011","Knowles Hill BUA","E34002310","Total",508,261,247,508,0,16,40.25,12.6
"2011","Allendale Town BUA","E34002311","Total",709,337,372,707,2,14,42.00,16.9
"2011","Blagdon Hill BUA","E34002312","Total",505,251,254,505,0,18,31.50,16.0
"2011","North Coker BUA","E34002313","Total",749,374,375,749,0,14,47.75,15.7
"2011","Gorefield BUA","E34002314","Total",977,464,513,971,6,5,68.75,14.2
"2011","Kensworth BUA","E34002315","Total",1455,717,738,1455,0,23,53.50,27.2
"2011","Elsham BUA","E34002316","Total",400,186,214,373,27,7,30.50,13.1
"2011","East Winch BUA","E34002317","Total",779,375,404,779,0,12,27.00,28.9
"2011","Scole BUA","E34002318","Total",1028,514,514,1027,1,8,43.25,23.8
"2011","Newton-on-Ouse BUA","E34002319","Total",599,304,295,599,0,11,23.25,25.8
"2011","Upton (Vale of White Horse) BUA","E34002320","Total",421,215,206,421,0,15,26.75,15.7
"2011","Fillongley BUA","E34002321","Total",695,360,335,695,0,8,36.50,19.0
"2011","Lower Green BUA","E34002322","Total",286,138,148,283,3,13,41.00,7.0
"2011","Bagby BUA","E34002323","Total",593,295,298,588,5,10,22.50,26.4
"2011","Market Rasen BUA","E34002324","Total",4773,2341,2432,4586,187,44,192.75,24.8
"2011","Musbury BUA","E34002325","Total",543,260,283,521,22,7,22.00,24.7
"2011","Wisbech St Mary BUA","E34002326","Total",977,463,514,977,0,15,80.25,12.2
"2011","Dolton BUA","E34002327","Total",687,333,354,683,4,11,34.50,19.9
"2011","Leven BUA","E34002328","Total",2433,1195,1238,2425,8,29,84.00,29.0
"2011","Framlingham BUA","E34002329","Total",3086,1473,1613,2846,240,63,132.50,23.3
"2011","Hales BUA","E34002330","Total",648,319,329,633,15,8,22.25,29.1
"2011","Shelfanger BUA","E34002331","Total",378,191,187,378,0,3,21.25,17.8
"2011","Ufford (Suffolk Coastal) BUA","E34002332","Total",556,286,270,556,0,15,49.25,11.3
"2011","Saltfleet BUA","E34002333","Total",543,273,270,536,7,4,34.50,15.7
"2011","Catherine-de-Barnes BUA","E34002334","Total",613,312,301,613,0,7,21.75,28.2
"2011","Kelvedon Hatch BUA","E34002335","Total",2400,1157,1243,2400,0,44,64.75,37.1
"2011","Bellingham BUA","E34002336","Total",1070,518,552,1068,2,15,48.50,22.1
"2011","Old Sarum BUA","E34002337","Total",987,456,531,974,13,11,47.50,20.8
"2011","Havenstreet BUA","E34002338","Total",432,196,236,370,62,3,24.50,17.6
"2011","Weston (Newark and Sherwood) BUA","E34002339","Total",393,194,199,383,10,10,22.25,17.7
"2011","Cliff End BUA","E34002340","Total",244,119,125,244,0,4,36.50,6.7
"2011","Kegworth BUA","E34002341","Total",3601,1766,1835,3541,60,48,114.25,31.5
"2011","Stockbridge BUA","E34002342","Total",757,365,392,742,15,23,49.25,15.4
"2011","Sedgeford BUA","E34002343","Total",613,304,309,613,0,18,24.50,25.0
"2011","Aldbrough BUA","E34002344","Total",1269,625,644,1263,6,10,38.00,33.4
"2011","Silkstone Common BUA","E34002345","Total",1389,673,716,1389,0,21,45.00,30.9
"2011","Thruxton Aerodrome BUA","E34002346","Total",650,317,333,650,0,11,179.50,3.6
"2011","Doddinghurst BUA","E34002347","Total",4435,2163,2272,4429,6,93,215.00,20.6
"2011","Long Stratton BUA","E34002348","Total",4434,2177,2257,4426,8,35,134.75,32.9
"2011","Lidlington BUA","E34002349","Total",1185,589,596,1185,0,12,31.25,37.9
"2011","Rackheath BUA","E34002350","Total",1628,796,832,1587,41,12,63.25,25.7
"2011","Four Lanes BUA","E34002351","Total",1416,721,695,1416,0,10,28.75,49.3
"2011","Berkeley BUA","E34002352","Total",2034,978,1056,2025,9,18,51.25,39.7
"2011","Carlton (Selby) BUA","E34002353","Total",1934,915,1019,1932,2,22,60.50,32.0
"2011","Childrey BUA","E34002354","Total",582,283,299,582,0,6,29.00,20.1
"2011","Arkesden BUA","E34002355","Total",366,177,189,366,0,19,21.50,17.0
"2011","Kingston Bagpuize BUA","E34002356","Total",2349,1143,1206,2346,3,69,74.75,31.4
"2011","Charlton (South Northamptonshire) BUA","E34002357","Total",528,262,266,528,0,4,22.75,23.2
"2011","Odiham Airfield BUA","E34002358","Total",1949,1269,680,1167,782,22,108.00,18.0
"2011","Easter Compton BUA","E34002359","Total",327,167,160,327,0,6,28.00,11.7
"2011","Westwoodside BUA","E34002360","Total",2050,997,1053,2050,0,40,117.75,17.4
"2011","Eastry BUA","E34002361","Total",2492,1194,1298,2450,42,22,83.50,29.8
"2011","Beckington BUA","E34002362","Total",849,423,426,847,2,17,45.50,18.7
"2011","Spratton BUA","E34002363","Total",1150,548,602,1150,0,19,41.75,27.5
"2011","Low Bentham BUA","E34002364","Total",688,338,350,683,5,15,25.50,27.0
"2011","Dickens Heath BUA","E34002365","Total",3992,2059,1933,3992,0,58,77.25,51.7
"2011","Walesby (Newark and Sherwood) BUA","E34002366","Total",1266,640,626,1266,0,11,38.25,33.1
"2011","Sherborne BUA","E34002367","Total",9523,4499,5024,8420,1103,159,303.50,31.4
"2011","Myddle BUA","E34002368","Total",349,163,186,349,0,1,25.00,14.0
"2011","Broomedge BUA","E34002369","Total",392,194,198,392,0,7,24.50,16.0
"2011","Darrington BUA","E34002370","Total",1182,578,604,1182,0,22,55.25,21.4
"2011","Ombersley BUA","E34002371","Total",623,312,311,623,0,5,55.75,11.2
"2011","Bridge BUA","E34002372","Total",1576,712,864,1499,77,30,51.75,30.5
"2011","Ulceby BUA","E34002373","Total",1584,767,817,1584,0,13,65.00,24.4
"2011","Ringmer BUA","E34002374","Total",3165,1489,1676,3104,61,40,103.75,30.5
"2011","Etwall BUA","E34002375","Total",2572,1281,1291,2503,69,43,77.00,33.4
"2011","Coates (Cotswold) BUA","E34002376","Total",507,249,258,507,0,20,34.50,14.7
"2011","Whitchurch Hill BUA","E34002377","Total",644,319,325,644,0,19,46.00,14.0
"2011","Wilstead BUA","E34002378","Total",2177,1037,1140,2177,0,18,82.50,26.4
"2011","Barrow upon Trent BUA","E34002379","Total",558,285,273,558,0,15,20.75,26.9
"2011","Croyde BUA","E34002380","Total",693,331,362,687,6,17,80.75,8.6
"2011","Middleton (Derbyshire Dales) BUA","E34002381","Total",775,394,381,775,0,4,40.75,19.0
"2011","Long Marston (Harrogate) BUA","E34002382","Total",635,321,314,635,0,16,38.75,16.4
"2011","Lelant BUA","E34002383","Total",1056,497,559,944,112,15,53.50,19.7
"2011","Silsden BUA","E34002384","Total",7912,3826,4086,7822,90,78,171.25,46.2
"2011","Burston BUA","E34002385","Total",568,285,283,568,0,10,22.50,25.2
"2011","Ansley BUA","E34002386","Total",854,424,430,854,0,7,23.75,36.0
"2011","Leyburn BUA","E34002387","Total",2183,1034,1149,2142,41,24,86.75,25.2
"2011","Onehouse BUA","E34002388","Total",877,417,460,780,97,18,22.50,39.0
"2011","Hollym BUA","E34002389","Total",339,175,164,339,0,4,36.50,9.3
"2011","Fishburn BUA","E34002390","Total",2588,1248,1340,2588,0,25,56.00,46.2
"2011","North Leigh BUA","E34002391","Total",1552,745,807,1552,0,28,59.25,26.2
"2011","Wistow (Huntingdonshire) BUA","E34002392","Total",522,262,260,522,0,17,26.25,19.9
"2011","Halwill Junction BUA","E34002393","Total",598,285,313,598,0,11,29.25,20.4
"2011","Henstridge BUA","E34002394","Total",1530,751,779,1530,0,19,52.75,29.0
"2011","Weston-sub-Edge BUA","E34002395","Total",431,204,227,431,0,5,22.00,19.6
"2011","Greens Norton BUA","E34002396","Total",1384,680,704,1384,0,31,49.25,28.1
"2011","Meppershall BUA","E34002397","Total",1745,837,908,1693,52,38,71.50,24.4
"2011","Dane End BUA","E34002398","Total",593,300,293,593,0,8,22.25,26.7
"2011","Stoke Holy Cross BUA","E34002399","Total",917,423,494,914,3,23,50.25,18.2
"2011","Woodbeck BUA","E34002400","Total",568,394,174,270,298,6,53.50,10.6
"2011","Kedington BUA","E34002401","Total",1849,902,947,1808,41,8,60.75,30.4
"2011","Quenington BUA","E34002402","Total",603,296,307,603,0,16,33.00,18.3
"2011","Porthleven BUA","E34002403","Total",3059,1468,1591,3059,0,23,88.75,34.5
"2011","Sharpstone Street BUA","E34002404","Total",448,226,222,446,2,1,23.75,18.9
"2011","Langham (Rutland) BUA","E34002405","Total",1371,662,709,1371,0,30,60.25,22.8
"2011","Wattisfield BUA","E34002406","Total",475,237,238,474,1,6,25.25,18.8
"2011","Newbold BUA","E34002407","Total",777,401,376,777,0,10,23.75,32.7
"2011","Tetsworth BUA","E34002408","Total",693,352,341,693,0,23,29.00,23.9
"2011","Bitton BUA","E34002409","Total",492,245,247,492,0,17,31.25,15.7
"2011","Ribchester BUA","E34002410","Total",888,446,442,887,1,17,22.00,40.4
"2011","Dinton (Aylesbury Vale) BUA","E34002411","Total",253,117,136,251,2,10,29.75,8.5
"2011","Thriplow BUA","E34002412","Total",488,246,242,488,0,18,50.00,9.8
"2011","Clifton (Fylde) BUA","E34002413","Total",894,451,443,894,0,9,33.50,26.7
"2011","Upper Seagry BUA","E34002414","Total",285,137,148,285,0,6,24.50,11.6
"2011","Creech St Michael BUA","E34002415","Total",1769,856,913,1769,0,17,65.00,27.2
"2011","Brafield-on-the-Green BUA","E34002416","Total",666,324,342,666,0,9,32.50,20.5
"2011","Sutton cum Lound BUA","E34002417","Total",673,327,346,673,0,11,38.75,17.4
"2011","Necton BUA","E34002418","Total",1798,885,913,1786,12,12,83.25,21.6
"2011","New Marske BUA","E34002419","Total",3271,1600,1671,3271,0,25,64.50,50.7
"2011","Hollesley BUA","E34002420","Total",583,291,292,566,17,10,41.50,14.0
"2011","Waddesdon BUA","E34002421","Total",1797,882,915,1794,3,45,50.00,35.9
"2011","Addingham BUA","E34002422","Total",3730,1794,1936,3730,0,86,101.00,36.9
"2011","Copplestone BUA","E34002423","Total",1253,622,631,1253,0,17,31.50,39.8
"2011","Troon BUA","E34002424","Total",1487,722,765,1487,0,6,36.50,40.7
"2011","Gringley on the Hill BUA","E34002425","Total",699,344,355,695,4,19,42.25,16.5
"2011","Carlton-le-Moorland BUA","E34002426","Total",565,284,281,565,0,10,26.50,21.3
"2011","Fairburn BUA","E34002427","Total",819,402,417,819,0,15,38.00,21.6
"2011","Glaisdale BUA","E34002428","Total",635,316,319,633,2,9,20.25,31.4
"2011","Stanley (Erewash) BUA","E34002429","Total",770,382,388,770,0,4,24.00,32.1
"2011","Wistow (Selby) BUA","E34002430","Total",1333,664,669,1333,0,17,54.25,24.6
"2011","Flyford Flavell BUA","E34002431","Total",254,130,124,252,2,7,23.25,10.9
"2011","Willington (County Durham) BUA","E34002432","Total",6633,3274,3359,6517,116,56,156.50,42.4
"2011","South Molton BUA","E34002433","Total",5108,2439,2669,5013,95,63,144.25,35.4
"2011","Holmwood BUA","E34002434","Total",1094,549,545,1094,0,10,33.00,33.2
"2011","Killinghall BUA","E34002435","Total",1057,502,555,1038,19,18,46.25,22.9
"2011","Bramcote BUA","E34002436","Total",833,532,301,557,276,13,50.00,16.7
"2011","Tolpuddle BUA","E34002437","Total",452,224,228,452,0,7,23.50,19.2
"2011","High Park Corner BUA","E34002438","Total",261,120,141,261,0,8,21.00,12.4
"2011","Grendon BUA","E34002439","Total",544,284,260,544,0,15,28.00,19.4
"2011","Shardlow BUA","E34002440","Total",637,316,321,611,26,10,32.25,19.8
"2011","Long Load BUA","E34002441","Total",332,169,163,332,0,10,25.00,13.3
"2011","Ashbocking BUA","E34002442","Total",356,192,164,356,0,9,29.50,12.1
"2011","Wilsford BUA","E34002443","Total",400,197,203,400,0,6,23.25,17.2
"2011","Eagle BUA","E34002444","Total",793,373,420,766,27,7,24.75,32.0
"2011","Minsterley BUA","E34002445","Total",1532,762,770,1532,0,18,57.00,26.9
"2011","Honiton BUA","E34002446","Total",11483,5401,6082,11388,95,125,321.00,35.8
"2011","Low Worsall BUA","E34002447","Total",279,149,130,279,0,6,22.75,12.3
"2011","Coton BUA","E34002448","Total",910,448,462,910,0,32,36.00,25.3
"2011","Marsden BUA","E34002449","Total",3889,1888,2001,3889,0,36,108.25,35.9
"2011","Winford (North Somerset) BUA","E34002450","Total",1165,567,598,1165,0,28,36.00,32.4
"2011","Esh Winning BUA","E34002451","Total",3666,1794,1872,3666,0,19,113.00,32.4
"2011","Little Gaddesden BUA","E34002452","Total",627,305,322,609,18,15,87.50,7.2
"2011","Southrepps BUA","E34002453","Total",537,262,275,537,0,5,26.50,20.3
"2011","Playing Place BUA","E34002454","Total",803,374,429,803,0,14,36.75,21.9
"2011","Stanhoe BUA","E34002455","Total",289,129,160,289,0,10,26.25,11.0
"2011","North Weald Bassett BUA","E34002456","Total",4477,2181,2296,4434,43,50,203.25,22.0
"2011","Gawcott BUA","E34002457","Total",778,377,401,769,9,19,27.75,28.0
"2011","Nettlesworth BUA","E34002458","Total",1093,548,545,1060,33,5,31.00,35.3
"2011","Kentisbeare BUA","E34002459","Total",597,275,322,597,0,13,21.00,28.4
"2011","Tiddington BUA","E34002460","Total",683,335,348,657,26,10,21.50,31.8
"2011","Durham Tees Valley International Airport BUA","E34002461","Total",302,152,150,302,0,6,352.25,0.9
"2011","Little Thetford BUA","E34002462","Total",792,400,392,792,0,6,31.50,25.1
"2011","Low Bradley BUA","E34002463","Total",1244,586,658,1176,68,32,32.25,38.6
"2011","Polruan BUA","E34002464","Total",614,289,325,614,0,10,29.25,21.0
"2011","Sutton Scotney BUA","E34002465","Total",858,384,474,831,27,15,30.75,27.9
"2011","Wickham Market BUA","E34002466","Total",2156,1025,1131,2120,36,18,76.75,28.1
"2011","Maisemore BUA","E34002467","Total",458,220,238,458,0,10,24.50,18.7
"2011","Dinton (Wiltshire) BUA","E34002468","Total",696,337,359,693,3,22,65.75,10.6
"2011","Eastbury BUA","E34002469","Total",276,133,143,276,0,12,21.75,12.7
"2011","Chippenham (Wiltshire) BUA","E34002470","Total",35800,17662,18138,35429,371,606,896.25,39.9
"2011","Milnthorpe BUA","E34002471","Total",2199,1066,1133,2085,114,37,66.25,33.2
"2011","Spaldwick BUA","E34002472","Total",631,325,306,631,0,15,33.75,18.7
"2011","Charminster BUA","E34002473","Total",1366,637,729,1340,26,25,56.25,24.3
"2011","Gillingham (North Dorset) BUA","E34002474","Total",11278,5525,5753,11142,136,171,306.25,36.8
"2011","Redbourn BUA","E34002475","Total",5113,2466,2647,5063,50,82,153.75,33.3
"2011","Stanion BUA","E34002476","Total",848,419,429,848,0,9,35.25,24.1
"2011","Swindon (South Staffordshire) BUA","E34002477","Total",1001,502,499,1001,0,10,27.75,36.1
"2011","Spittlegate BUA","E34002478","Total",225,120,105,225,0,0,21.25,10.6
"2011","Witham St Hughs BUA","E34002479","Total",2104,1027,1077,2104,0,24,156.25,13.5
"2011","Modbury BUA","E34002480","Total",1372,639,733,1372,0,34,54.50,25.2
"2011","Brancaster BUA","E34002481","Total",430,207,223,430,0,11,52.00,8.3
"2011","Widemouth Bay BUA","E34002482","Total",331,155,176,331,0,4,21.75,15.2
"2011","Sedgeberrow BUA","E34002483","Total",845,417,428,845,0,36,45.00,18.8
"2011","Iron Acton BUA","E34002484","Total",516,248,268,514,2,6,29.75,17.3
"2011","Great Shefford BUA","E34002485","Total",937,462,475,933,4,23,35.75,26.2
"2011","Ditton Priors BUA","E34002486","Total",821,381,440,750,71,12,32.75,25.1
"2011","St Newlyn East BUA","E34002487","Total",896,425,471,896,0,8,28.75,31.2
"2011","Eaton Bray BUA","E34002488","Total",3912,1920,1992,3912,0,83,144.00,27.2
"2011","Woodmansey BUA","E34002489","Total",756,390,366,756,0,3,34.25,22.1
"2011","Charlton Marshall BUA","E34002490","Total",1026,480,546,1026,0,20,46.25,22.2
"2011","Laughterton BUA","E34002491","Total",426,219,207,426,0,7,27.00,15.8
"2011","Stradbroke BUA","E34002492","Total",1089,538,551,1089,0,16,68.00,16.0
"2011","Stokesley BUA","E34002493","Total",4757,2224,2533,4757,0,89,186.00,25.6
"2011","Bitchet Green BUA","E34002494","Total",307,147,160,307,0,15,23.00,13.3
"2011","Bretherton BUA","E34002495","Total",437,210,227,437,0,17,51.75,8.4
"2011","Northwold BUA","E34002496","Total",736,365,371,736,0,7,47.50,15.5
"2011","Netherseal BUA","E34002497","Total",694,345,349,658,36,2,27.50,25.2
"2011","Kirby Misperton BUA","E34002498","Total",370,185,185,350,20,7,71.50,5.2
"2011","Lindale BUA","E34002499","Total",579,290,289,576,3,3,33.50,17.3
"2011","Grendon Underwood BUA","E34002500","Total",637,309,328,635,2,16,37.75,16.9
"2011","South Witham BUA","E34002501","Total",1533,748,785,1532,1,12,42.50,36.1
"2011","Flexbury BUA","E34002502","Total",2211,1055,1156,2158,53,40,70.00,31.6
"2011","Wethersfield BUA","E34002503","Total",691,344,347,691,0,12,25.25,27.4
"2011","Amberley BUA","E34002504","Total",586,276,310,586,0,12,20.25,28.9
"2011","West Mersea BUA","E34002505","Total",7057,3341,3716,7046,11,86,278.50,25.3
"2011","Hanwood BUA","E34002506","Total",1090,527,563,1085,5,22,44.25,24.6
"2011","Lavenham BUA","E34002507","Total",1413,657,756,1404,9,19,70.50,20.0
"2011","Roxton BUA","E34002508","Total",348,174,174,348,0,8,24.00,14.5
"2011","Ambleside BUA","E34002509","Total",2529,1249,1280,2412,117,43,123.75,20.4
"2011","Rimpton BUA","E34002510","Total",235,118,117,235,0,9,21.00,11.2
"2011","Tring BUA","E34002511","Total",11929,5773,6156,11693,236,293,299.00,39.9
"2011","Guisborough BUA","E34002512","Total",16979,8220,8759,16756,223,222,431.50,39.3
"2011","Farnsfield BUA","E34002513","Total",2566,1266,1300,2566,0,52,93.25,27.5
"2011","Combwich BUA","E34002514","Total",693,338,355,693,0,9,28.00,24.8
"2011","Longframlington BUA","E34002515","Total",864,411,453,861,3,18,43.75,19.7
"2011","Utterby BUA","E34002516","Total",293,151,142,293,0,5,20.50,14.3
"2011","Great Gidding BUA","E34002517","Total",363,183,180,363,0,2,28.25,12.8
"2011","Elham BUA","E34002518","Total",911,441,470,911,0,15,47.00,19.4
"2011","Willoughby (Rugby) BUA","E34002519","Total",398,184,214,398,0,7,25.00,15.9
"2011","Hamsterley Mill BUA","E34002520","Total",309,158,151,309,0,8,34.25,9.0
"2011","Luckington BUA","E34002521","Total",630,290,340,630,0,23,25.00,25.2
"2011","Turvey BUA","E34002522","Total",940,461,479,926,14,25,34.25,27.4
"2011","Longborough BUA","E34002523","Total",471,239,232,460,11,14,28.75,16.4
"2011","Dove Holes BUA","E34002524","Total",1113,587,526,1113,0,8,36.00,30.9
"2011","Farnborough (Stratford-on-Avon) BUA","E34002525","Total",265,126,139,265,0,4,21.00,12.6
"2011","Bishampton BUA","E34002526","Total",675,359,316,675,0,16,36.25,18.6
"2011","Great Barton BUA","E34002527","Total",1600,807,793,1581,19,26,124.50,12.9
"2011","Olney BUA","E34002528","Total",6477,3125,3352,6378,99,144,160.50,40.4
"2011","New Alresford BUA","E34002529","Total",5431,2592,2839,5428,3,134,172.00,31.6
"2011","Wilberfoss BUA","E34002530","Total",1866,904,962,1866,0,27,55.25,33.8
"2011","Longhoughton BUA","E34002531","Total",1383,673,710,1383,0,15,44.75,30.9
"2011","St Columb Major BUA","E34002532","Total",3672,1793,1879,3630,42,36,111.75,32.9
"2011","Peopleton BUA","E34002533","Total",585,280,305,585,0,16,24.50,23.9
"2011","Chearsley BUA","E34002534","Total",539,258,281,539,0,13,26.25,20.5
"2011","Tatworth BUA","E34002535","Total",2259,1104,1155,2255,4,22,106.50,21.2
"2011","Week St Mary BUA","E34002536","Total",709,345,364,690,19,6,27.00,26.3
"2011","Mepal BUA","E34002537","Total",982,503,479,982,0,1,37.25,26.4
"2011","Toynton All Saints BUA","E34002538","Total",443,230,213,370,73,4,27.25,16.3
"2011","Sheriffhales BUA","E34002539","Total",361,172,189,349,12,9,22.50,16.0
"2011","Marchwood BUA","E34002540","Total",6141,3076,3065,6022,119,82,253.75,24.2
"2011","Kingsdown (Wiltshire) BUA","E34002541","Total",269,131,138,264,5,6,21.25,12.7
"2011","Rudheath Woods BUA","E34002542","Total",218,115,103,218,0,6,36.00,6.1
"2011","Croxton BUA","E34002543","Total",261,132,129,261,0,2,22.75,11.5
"2011","Kilcot BUA","E34002544","Total",273,127,146,265,8,2,23.25,11.7
"2011","Belchford BUA","E34002545","Total",255,128,127,255,0,2,26.75,9.5
"2011","Long Itchington BUA","E34002546","Total",1683,818,865,1683,0,31,64.75,26.0
"2011","Shotley Gate BUA","E34002547","Total",1511,742,769,1511,0,17,49.00,30.8
"2011","High Ercall BUA","E34002548","Total",686,347,339,686,0,10,29.75,23.1
"2011","Condover BUA","E34002549","Total",721,325,396,699,22,9,37.25,19.4
"2011","Castleside BUA","E34002550","Total",4881,2395,2486,4858,23,49,118.50,41.2
"2011","Marsh Baldon BUA","E34002551","Total",310,140,170,310,0,8,29.25,10.6
"2011","North Elmham BUA","E34002552","Total",1124,550,574,1123,1,14,57.25,19.6
"2011","Cookshill BUA","E34002553","Total",334,166,168,334,0,3,22.25,15.0
"2011","Rugeley BUA","E34002554","Total",24033,11813,12220,23827,206,159,649.25,37.0
"2011","Hellifield BUA","E34002555","Total",1426,702,724,1426,0,19,32.25,44.2
"2011","Milborne St Andrew BUA","E34002556","Total",1062,512,550,1062,0,15,37.00,28.7
"2011","Woodborough (Gedling) BUA","E34002557","Total",1659,808,851,1659,0,48,83.25,19.9
"2011","Coven BUA","E34002558","Total",2694,1355,1339,2694,0,36,61.50,43.8
"2011","Poughill BUA","E34002559","Total",712,344,368,657,55,9,27.25,26.1
"2011","Etchingham BUA","E34002560","Total",405,202,203,405,0,4,25.00,16.2
"2011","Keelby BUA","E34002561","Total",2092,1018,1074,2092,0,38,70.00,29.9
"2011","Saffron Walden BUA","E34002562","Total",15210,7396,7814,14991,219,289,370.00,41.1
"2011","Wolsingham BUA","E34002563","Total",2503,1191,1312,2503,0,42,72.75,34.4
"2011","Cutnall Green BUA","E34002564","Total",488,240,248,488,0,15,24.75,19.7
"2011","Draycott BUA","E34002565","Total",1057,488,569,1024,33,19,47.25,22.4
"2011","Shadoxhurst BUA","E34002566","Total",1287,610,677,1287,0,17,62.50,20.6
"2011","Blackfordby BUA","E34002567","Total",865,418,447,865,0,5,34.00,25.4
"2011","Bawdeswell BUA","E34002568","Total",828,394,434,828,0,6,27.75,29.8
"2011","Snape (Hambleton) BUA","E34002569","Total",410,200,210,410,0,11,25.50,16.1
"2011","Bletchingdon BUA","E34002570","Total",617,316,301,617,0,10,23.75,26.0
"2011","Sharow BUA","E34002571","Total",556,245,311,521,35,18,33.25,16.7
"2011","Bourton-on-the-Water BUA","E34002572","Total",3296,1563,1733,3246,50,59,136.50,24.1
"2011","Tregony BUA","E34002573","Total",768,345,423,768,0,9,32.50,23.6
"2011","Hinstock BUA","E34002574","Total",861,419,442,820,41,19,31.25,27.6
"2011","Haynes BUA","E34002575","Total",940,472,468,940,0,23,39.75,23.6
"2011","Hathern BUA","E34002576","Total",1866,919,947,1859,7,20,63.00,29.6
"2011","East Boldre BUA","E34002577","Total",616,313,303,616,0,4,63.00,9.8
"2011","Stamfordham BUA","E34002578","Total",347,169,178,344,3,9,24.75,14.0
"2011","Odcombe BUA","E34002579","Total",759,376,383,749,10,4,36.00,21.1
"2011","Wroot BUA","E34002580","Total",455,233,222,455,0,7,44.50,10.2
"2011","Finmere BUA","E34002581","Total",466,228,238,466,0,7,24.25,19.2
"2011","Kirdford BUA","E34002582","Total",745,366,379,745,0,13,24.75,30.1
"2011","Loddiswell BUA","E34002583","Total",777,377,400,777,0,8,23.75,32.7
"2011","Wittersham BUA","E34002584","Total",776,365,411,776,0,13,44.75,17.3
"2011","Waldringfield BUA","E34002585","Total",464,231,233,464,0,18,33.75,13.7
"2011","Kingsclere BUA","E34002586","Total",3164,1550,1614,3164,0,57,107.00,29.6
"2011","Clifton Hampden BUA","E34002587","Total",301,143,158,301,0,12,20.50,14.7
"2011","Shenington BUA","E34002588","Total",425,203,222,425,0,24,22.50,18.9
"2011","Bucknell (Cherwell) BUA","E34002589","Total",260,119,141,260,0,4,22.50,11.6
"2011","Gotham BUA","E34002590","Total",1563,764,799,1563,0,19,55.50,28.2
"2011","Fincham BUA","E34002591","Total",496,229,267,496,0,6,27.00,18.4
"2011","Inner Hope BUA","E34002592","Total",249,117,132,217,32,2,33.50,7.4
"2011","Wouldham BUA","E34002593","Total",1253,595,658,1125,128,12,20.25,61.9
"2011","Henley BUA","E34002594","Total",573,289,284,573,0,10,21.00,27.3
"2011","Salhouse BUA","E34002595","Total",987,496,491,987,0,19,50.75,19.4
"2011","Wootton (West Oxfordshire) BUA","E34002596","Total",569,269,300,569,0,16,30.00,19.0
"2011","Westbury (Aylesbury Vale) BUA","E34002597","Total",447,224,223,444,3,13,23.25,19.2
"2011","Mawnan Smith BUA","E34002598","Total",865,397,468,844,21,9,52.75,16.4
"2011","Westcott BUA","E34002599","Total",2528,1225,1303,2460,68,71,132.50,19.1
"2011","Badwell Ash BUA","E34002600","Total",770,364,406,768,2,20,35.75,21.5
"2011","Naseby BUA","E34002601","Total",687,351,336,687,0,9,29.00,23.7
"2011","Wellington (County of Herefordshire) BUA","E34002602","Total",1005,496,509,999,6,16,40.50,24.8
"2011","Rempstone BUA","E34002603","Total",367,180,187,367,0,14,24.75,14.8
"2011","Norham BUA","E34002604","Total",579,263,316,560,19,4,25.50,22.7
"2011","Knutsford BUA","E34002605","Total",13191,6357,6834,13136,55,262,439.50,30.0
"2011","North Muskham BUA","E34002606","Total",985,479,506,980,5,20,59.00,16.7
"2011","Snainton BUA","E34002607","Total",754,343,411,752,2,13,55.00,13.7
"2011","Shepley BUA","E34002608","Total",5444,2657,2787,5444,0,114,156.50,34.8
"2011","Biggleswade BUA","E34002609","Total",16551,8136,8415,16451,100,161,394.00,42.0
"2011","Broom BUA","E34002610","Total",579,290,289,579,0,8,28.50,20.3
"2011","Brassington BUA","E34002611","Total",573,299,274,573,0,6,22.75,25.2
"2011","Curry Rivel BUA","E34002612","Total",1844,885,959,1844,0,43,92.50,19.9
"2011","Stocksfield BUA","E34002613","Total",2616,1274,1342,2595,21,72,151.75,17.2
"2011","Hadlow BUA","E34002614","Total",2849,1380,1469,2849,0,41,84.00,33.9
"2011","Rawcliffe Bridge BUA","E34002615","Total",837,425,412,837,0,15,33.75,24.8
"2011","Northleach BUA","E34002616","Total",1854,862,992,1804,50,44,52.25,35.5
"2011","Overstrand BUA","E34002617","Total",1030,503,527,944,86,12,66.75,15.4
"2011","Hinton Waldrist BUA","E34002618","Total",328,169,159,328,0,20,28.00,11.7
"2011","Great Barrow BUA","E34002619","Total",578,316,262,543,35,9,22.75,25.4
"2011","Colkirk BUA","E34002620","Total",588,291,297,588,0,6,35.00,16.8
"2011","Longworth BUA","E34002621","Total",566,283,283,566,0,20,28.00,20.2
"2011","Twyning BUA","E34002622","Total",881,431,450,881,0,20,48.25,18.3
"2011","Fotherby BUA","E34002623","Total",482,227,255,464,18,12,20.25,23.8
"2011","Ripon BUA","E34002624","Total",16363,8208,8155,15609,754,183,510.00,32.1
"2011","Southwick (Wiltshire) BUA","E34002625","Total",1754,862,892,1751,3,16,57.00,30.8
"2011","Aldermaston Wharf BUA","E34002626","Total",940,494,446,920,20,14,43.25,21.7
"2011","Ramsey (Wiltshire) BUA","E34002627","Total",1989,975,1014,1931,58,62,78.25,25.4
"2011","Littledean BUA","E34002628","Total",952,484,468,950,2,8,28.00,34.0
"2011","Blindley Heath BUA","E34002629","Total",1123,554,569,1123,0,26,102.00,11.0
"2011","Carlton (Bedford) BUA","E34002630","Total",874,428,446,843,31,23,35.75,24.4
"2011","Kellington BUA","E34002631","Total",991,491,500,965,26,8,33.25,29.8
"2011","Appleton Thorn BUA","E34002632","Total",1324,792,532,1023,301,40,135.25,9.8
"2011","South Cockerington BUA","E34002633","Total",245,127,118,245,0,1,21.00,11.7
"2011","Islip BUA","E34002634","Total",652,317,335,652,0,21,38.00,17.2
"2011","Crow Hill BUA","E34002635","Total",602,304,298,602,0,13,22.00,27.4
"2011","Aldington BUA","E34002636","Total",988,468,520,969,19,15,50.50,19.6
"2011","Selsey BUA","E34002637","Total",10550,4956,5594,10319,231,74,378.75,27.9
"2011","Hempstead BUA","E34002638","Total",451,234,217,451,0,16,27.50,16.4
"2011","Bishopthorpe BUA","E34002639","Total",3237,1565,1672,3231,6,77,88.50,36.6
"2011","Cawston BUA","E34002640","Total",1172,586,586,1172,0,9,49.50,23.7
"2011","Clapton in Gordano BUA","E34002641","Total",348,172,176,348,0,11,31.25,11.1
"2011","Cockfield BUA","E34002642","Total",1531,767,764,1530,1,9,47.25,32.4
"2011","Bromham (Bedford) BUA","E34002643","Total",4670,2265,2405,4665,5,108,157.25,29.7
"2011","Calvert BUA","E34002644","Total",1265,626,639,1265,0,28,25.00,50.6
"2011","Hugh town BUA","E34002645","Total",1097,543,554,1022,75,32,47.50,23.1
"2011","Kingstone (East Staffordshire) BUA","E34002646","Total",629,316,313,629,0,7,23.25,27.1
"2011","High Shincliffe BUA","E34002647","Total",1141,541,600,1141,0,40,32.25,35.4
"2011","Willoughton BUA","E34002648","Total",341,179,162,341,0,1,27.50,12.4
"2011","Sadberge BUA","E34002649","Total",691,325,366,691,0,8,24.50,28.2
"2011","Elsworth BUA","E34002650","Total",566,286,280,566,0,19,44.50,12.7
"2011","South Darenth BUA","E34002651","Total",4688,2255,2433,4688,0,41,91.25,51.4
"2011","Trunch BUA","E34002652","Total",909,441,468,909,0,10,50.50,18.0
"2011","Ilfracombe BUA","E34002653","Total",11184,5429,5755,10784,400,102,269.00,41.6
"2011","Stoney Stratton BUA","E34002654","Total",311,153,158,311,0,15,20.50,15.2
"2011","Great Houghton (Barnsley) BUA","E34002655","Total",2475,1192,1283,2435,40,14,57.75,42.9
"2011","Kirkby Mallory BUA","E34002656","Total",383,190,193,382,1,13,35.00,10.9
"2011","Aldreth BUA","E34002657","Total",281,142,139,281,0,5,21.75,12.9
"2011","Hullavington BUA","E34002658","Total",880,435,445,880,0,31,33.25,26.5
"2011","Theydon Bois BUA","E34002659","Total",3829,1834,1995,3745,84,79,134.75,28.4
"2011","Cowfold BUA","E34002660","Total",1301,648,653,1301,0,23,45.00,28.9
"2011","Hamsterley (nr Consett) BUA","E34002661","Total",1030,498,532,983,47,9,29.00,35.5
"2011","Thursley BUA","E34002662","Total",305,147,158,305,0,16,24.50,12.4
"2011","Uffington (South Kesteven) BUA","E34002663","Total",512,243,269,512,0,14,36.75,13.9
"2011","Polperro BUA","E34002664","Total",1206,596,610,1206,0,17,69.25,17.4
"2011","Chilbolton BUA","E34002665","Total",862,400,462,862,0,23,54.25,15.9
"2011","Burgh by Sands BUA","E34002666","Total",596,284,312,596,0,14,32.75,18.2
"2011","Ford BUA","E34002667","Total",697,340,357,697,0,5,28.75,24.2
"2011","Alfold Crossways BUA","E34002668","Total",671,323,348,671,0,7,39.25,17.1
"2011","Fladbury BUA","E34002669","Total",641,306,335,641,0,16,38.25,16.8
"2011","Netherton BUA","E34002670","Total",2479,1222,1257,2479,0,28,56.75,43.7
"2011","Wattisham Airfield BUA","E34002671","Total",2284,1486,798,1543,741,42,193.25,11.8
"2011","Hitcham BUA","E34002672","Total",774,393,381,771,3,20,21.50,36.0
"2011","Crouch BUA","E34002673","Total",511,257,254,511,0,14,24.25,21.1
"2011","Long Buckby BUA","E34002674","Total",3759,1876,1883,3759,0,68,107.75,34.9
"2011","Hevingham BUA","E34002675","Total",967,491,476,967,0,7,48.00,20.1
"2011","Adisham BUA","E34002676","Total",645,322,323,636,9,15,25.50,25.3
"2011","Stow-on-the-Wold BUA","E34002677","Total",2042,956,1086,1983,59,32,76.75,26.6
"2011","Saltburn-by-the-Sea BUA","E34002678","Total",5958,2872,3086,5717,241,64,136.50,43.6
"2011","Hilgay BUA","E34002679","Total",874,450,424,874,0,19,48.50,18.0
"2011","Bluntisham BUA","E34002680","Total",2868,1433,1435,2866,2,64,120.00,23.9
"2011","Prickwillow BUA","E34002681","Total",354,186,168,354,0,6,23.25,15.2
"2011","Redgrave BUA","E34002682","Total",459,215,244,459,0,7,37.25,12.3
"2011","St Stephen BUA","E34002683","Total",2251,1096,1155,2250,1,21,60.25,37.4
"2011","Hatfield Broad Oak BUA","E34002684","Total",916,447,469,916,0,19,40.75,22.5
"2011","Scopwick BUA","E34002685","Total",815,457,358,641,174,13,26.75,30.5
"2011","Ventnor BUA","E34002686","Total",5976,2888,3088,5792,184,54,264.00,22.6
"2011","Silverton BUA","E34002687","Total",1494,697,797,1494,0,14,47.75,31.3
"2011","Combe Martin BUA","E34002688","Total",2687,1294,1393,2672,15,27,120.50,22.3
"2011","Newton Aycliffe BUA","E34002689","Total",25964,12509,13455,25668,296,265,890.00,29.2
"2011","Marham Airfield BUA","E34002690","Total",2798,1706,1092,2011,787,61,456.25,6.1
"2011","Hadston BUA","E34002691","Total",3570,2262,1308,2455,1115,20,71.00,50.3
"2011","Walberswick BUA","E34002692","Total",380,165,215,376,4,18,51.50,7.4
"2011","Guilden Sutton BUA","E34002693","Total",1467,718,749,1467,0,41,44.00,33.3
"2011","Newbiggin-by-the-Sea BUA","E34002694","Total",6308,3034,3274,6242,66,30,117.00,53.9
"2011","Sherington BUA","E34002695","Total",954,457,497,954,0,30,47.50,20.1
"2011","Whixley BUA","E34002696","Total",363,177,186,363,0,6,30.00,12.1
"2011","Felton (Northumberland) BUA","E34002697","Total",1126,547,579,1126,0,30,52.25,21.6
"2011","Bromyard BUA","E34002698","Total",4117,2018,2099,3968,149,37,120.00,34.3
"2011","Dobwalls BUA","E34002699","Total",1418,662,756,1418,0,13,38.00,37.3
"2011","Fritwell BUA","E34002700","Total",736,362,374,736,0,9,32.00,23.0
"2011","Elmdon BUA","E34002701","Total",289,144,145,289,0,13,39.00,7.4
"2011","Aughton BUA","E34002702","Total",294,145,149,294,0,5,39.75,7.4
"2011","Kirkby Overblow BUA","E34002703","Total",462,233,229,462,0,17,22.25,20.8
"2011","Marsworth BUA","E34002704","Total",741,358,383,741,0,20,21.00,35.3
"2011","Empingham BUA","E34002705","Total",880,423,457,880,0,22,43.50,20.2
"2011","Harby BUA","E34002706","Total",931,473,458,931,0,17,38.25,24.3
"2011","Darley Dale BUA","E34002707","Total",665,332,333,663,2,8,41.25,16.1
"2011","Brading BUA","E34002708","Total",1800,848,952,1797,3,24,69.75,25.8
"2011","Croft (Blaby) BUA","E34002709","Total",1639,796,843,1639,0,21,83.50,19.6
"2011","Grewelthorpe BUA","E34002710","Total",498,253,245,490,8,15,24.25,20.5
"2011","Bures BUA","E34002711","Total",1433,692,741,1433,0,34,53.00,27.0
"2011","Filey BUA","E34002712","Total",6530,3060,3470,6527,3,58,175.75,37.2
"2011","Abridge BUA","E34002713","Total",1613,772,841,1613,0,12,46.50,34.7
"2011","Leadenham BUA","E34002714","Total",410,215,195,410,0,19,31.75,12.9
"2011","West Coker BUA","E34002715","Total",1161,571,590,1161,0,33,47.50,24.4
"2011","Madeley BUA","E34002716","Total",3893,1875,2018,3853,40,75,150.25,25.9
"2011","Hoo St Werburgh BUA","E34002717","Total",6113,2957,3156,6099,14,46,129.00,47.4
"2011","Kings Sutton BUA","E34002718","Total",2116,1020,1096,2116,0,46,65.75,32.2
"2011","Gamble's Green BUA","E34002719","Total",342,166,176,342,0,4,24.25,14.1
"2011","Horton (South Northamptonshire) BUA","E34002720","Total",362,179,183,362,0,12,31.50,11.5
"2011","Kirkbymoorside BUA","E34002721","Total",2751,1317,1434,2748,3,23,95.25,28.9
"2011","Fairfield BUA","E34002722","Total",982,498,484,982,0,30,72.25,13.6
"2011","Ashford (North Devon) BUA","E34002723","Total",267,135,132,267,0,11,22.75,11.7
"2011","Lowdham BUA","E34002724","Total",2234,1080,1154,2212,22,43,103.75,21.5
"2011","Newington BUA","E34002725","Total",2164,1016,1148,2164,0,14,91.25,23.7
"2011","Kington Magna BUA","E34002726","Total",389,200,189,389,0,14,25.75,15.1
"2011","Arlesey BUA","E34002727","Total",5584,2765,2819,5522,62,60,135.00,41.4
"2011","Lindal in Furness BUA","E34002728","Total",755,384,371,755,0,12,20.75,36.4
"2011","South Woodham Ferrers BUA","E34002729","Total",16453,8123,8330,16381,72,257,332.25,49.5
"2011","Earls Barton BUA","E34002730","Total",5387,2618,2769,5367,20,92,142.50,37.8
"2011","Halvergate BUA","E34002731","Total",607,305,302,605,2,2,30.00,20.2
"2011","Wroxall BUA","E34002732","Total",1753,848,905,1753,0,18,58.50,30.0
"2011","Lichfield BUA","E34002733","Total",32877,16129,16748,32595,282,512,867.75,37.9
"2011","Saltford BUA","E34002734","Total",4073,1995,2078,4054,19,91,137.50,29.6
"2011","Keswick (Allerdale) BUA","E34002735","Total",4821,2324,2497,4555,266,76,220.25,21.9
"2011","Milland BUA","E34002736","Total",326,167,159,326,0,12,20.25,16.1
"2011","Holsworthy BUA","E34002737","Total",2641,1262,1379,2568,73,15,104.00,25.4
"2011","Duns Tew BUA","E34002738","Total",478,227,251,477,1,27,27.75,17.2
"2011","Credenhill BUA","E34002739","Total",2271,1160,1111,2176,95,31,97.00,23.4
"2011","Shipton (Hambleton) BUA","E34002740","Total",872,418,454,826,46,21,41.50,21.0
"2011","Cricklade BUA","E34002741","Total",4030,1978,2052,3996,34,74,106.00,38.0
"2011","Newgate Street BUA","E34002742","Total",412,196,216,412,0,11,38.00,10.8
"2011","Lanchester BUA","E34002743","Total",3543,1714,1829,3539,4,56,109.00,32.5
"2011","Mannings Heath BUA","E34002744","Total",1108,515,593,1108,0,28,61.25,18.1
"2011","Wicklewood BUA","E34002745","Total",700,325,375,691,9,15,55.50,12.6
"2011","Calverton BUA","E34002746","Total",6868,3270,3598,6827,41,69,195.25,35.2
"2011","Threehammer Common BUA","E34002747","Total",565,261,304,565,0,7,21.00,26.9
"2011","Didmarton BUA","E34002748","Total",415,214,201,414,1,15,20.75,20.0
"2011","Sandwich BUA","E34002749","Total",4599,2185,2414,4520,79,84,158.00,29.1
"2011","Thurgoland BUA","E34002750","Total",1216,587,629,1216,0,18,35.75,34.0
"2011","Bere Regis BUA","E34002751","Total",1304,639,665,1304,0,15,43.50,30.0
"2011","Alkham BUA","E34002752","Total",351,160,191,351,0,6,32.75,10.7
"2011","Geddington BUA","E34002753","Total",1503,723,780,1503,0,16,56.50,26.6
"2011","Roche BUA","E34002754","Total",2517,1225,1292,2480,37,19,59.25,42.5
"2011","Wellow (Bath and North East Somerset) BUA","E34002755","Total",529,249,280,529,0,7,27.25,19.4
"2011","Cheddington BUA","E34002756","Total",1634,794,840,1634,0,35,41.75,39.1
"2011","Beachley BUA","E34002757","Total",764,432,332,639,125,15,43.25,17.7
"2011","Packington BUA","E34002758","Total",734,356,378,734,0,16,44.50,16.5
"2011","Otterton BUA","E34002759","Total",656,300,356,637,19,10,33.00,19.9
"2011","Whittingham BUA","E34002760","Total",280,136,144,280,0,4,20.75,13.5
"2011","Slapton BUA","E34002761","Total",182,84,98,182,0,1,24.25,7.5
"2011","Funtington BUA","E34002762","Total",352,166,186,352,0,17,25.00,14.1
"2011","Wreningham BUA","E34002763","Total",318,142,176,318,0,15,29.50,10.8
"2011","Hotham BUA","E34002764","Total",233,122,111,233,0,7,25.50,9.1
"2011","Willand BUA","E34002765","Total",3360,1644,1716,3330,30,40,109.25,30.8
"2011","Blackfield BUA","E34002766","Total",13712,6663,7049,13681,31,111,837.50,16.4
"2011","Stickney BUA","E34002767","Total",1127,542,585,1105,22,12,68.25,16.5
"2011","St. Edward's Park BUA","E34002768","Total",787,398,389,787,0,18,23.75,33.1
"2011","Torton BUA","E34002769","Total",303,160,143,303,0,6,23.75,12.8
"2011","Madron BUA","E34002770","Total",626,298,328,624,2,8,21.75,28.8
"2011","Ash (Dover) BUA","E34002771","Total",2543,1261,1282,2469,74,19,89.75,28.3
"2011","Normanton-on-the-Wolds BUA","E34002772","Total",245,117,128,245,0,10,27.50,8.9
"2011","Sculthorpe BUA","E34002773","Total",289,136,153,289,0,4,101.75,2.8
"2011","Barmby on the Marsh BUA","E34002774","Total",372,193,179,372,0,3,23.25,16.0
"2011","Hawksworth BUA","E34002775","Total",154,78,76,154,0,4,21.25,7.2
"2011","Bedale BUA","E34002776","Total",4601,2225,2376,4522,79,70,144.00,32.0
"2011","Bretforton BUA","E34002777","Total",1052,526,526,1052,0,19,54.75,19.2
"2011","Bilbrough BUA","E34002778","Total",348,174,174,348,0,9,21.25,16.4
"2011","Hempnall BUA","E34002779","Total",962,467,495,962,0,14,48.50,19.8
"2011","Sheering BUA","E34002780","Total",891,451,440,891,0,15,40.75,21.9
"2011","Old Sodbury BUA","E34002781","Total",661,341,320,650,11,12,27.50,24.0
"2011","Appleby BUA","E34002782","Total",305,147,158,288,17,2,33.00,9.2
"2011","West Tytherley BUA","E34002783","Total",332,173,159,283,49,11,24.00,13.8
"2011","Castle Cary BUA","E34002784","Total",3232,1510,1722,3116,116,44,125.50,25.8
"2011","South Kyme BUA","E34002785","Total",393,201,192,393,0,6,23.75,16.5
"2011","Brighstone BUA","E34002786","Total",1157,532,625,1157,0,24,79.50,14.6
"2011","New Bolingbroke BUA","E34002787","Total",289,143,146,289,0,4,20.75,13.9
"2011","Cheselbourne BUA","E34002788","Total",296,146,150,296,0,6,21.75,13.6
"2011","Cuddington (Cheshire West and Chester) BUA","E34002789","Total",843,414,429,843,0,20,48.75,17.3
"2011","Sling BUA","E34002790","Total",834,401,433,834,0,5,41.00,20.3
"2011","Dorrington (North Kesteven) BUA","E34002791","Total",344,174,170,344,0,9,28.50,12.1
"2011","Braishfield BUA","E34002792","Total",684,338,346,684,0,21,34.75,19.7
"2011","Kirklevington BUA","E34002793","Total",809,409,400,809,0,20,40.75,19.9
"2011","Lamberhurst BUA","E34002794","Total",1147,584,563,1147,0,21,66.00,17.4
"2011","Fortuneswell BUA","E34002795","Total",3381,1668,1713,3372,9,27,111.25,30.4
"2011","Yaxley BUA","E34002796","Total",9174,4472,4702,9142,32,100,245.50,37.4
"2011","Upper Tean BUA","E34002797","Total",3345,1649,1696,3331,14,46,87.50,38.2
"2011","Ullenhall BUA","E34002798","Total",353,174,179,353,0,5,33.00,10.7
"2011","Sewards End BUA","E34002799","Total",511,251,260,511,0,26,39.75,12.9
"2011","Burtonwood BUA","E34002800","Total",3361,1623,1738,3332,29,20,72.25,46.5
"2011","Lymm BUA","E34002801","Total",11608,5670,5938,11519,89,264,312.75,37.1
"2011","South Cerney Army Station BUA","E34002802","Total",621,361,260,437,184,10,34.50,18.0
"2011","Horsington BUA","E34002803","Total",291,148,143,286,5,10,21.25,13.7
"2011","Orston BUA","E34002804","Total",454,223,231,454,0,10,27.75,16.4
"2011","Clophill BUA","E34002805","Total",2369,1162,1207,2364,5,42,78.25,30.3
"2011","Pangbourne BUA","E34002806","Total",3802,1829,1973,3574,228,105,188.25,20.2
"2011","Thurcaston BUA","E34002807","Total",877,419,458,871,6,11,45.00,19.5
"2011","Wigmore BUA","E34002808","Total",757,364,393,746,11,16,36.25,20.9
"2011","Holt (North Norfolk) BUA","E34002809","Total",3810,1757,2053,3485,325,58,164.75,23.1
"2011","Upper Broadheath BUA","E34002810","Total",322,160,162,322,0,9,46.25,7.0
"2011","South Warnborough BUA","E34002811","Total",454,221,233,454,0,20,29.25,15.5
"2011","Melbourn BUA","E34002812","Total",4689,2272,2417,4653,36,84,149.00,31.5
"2011","Gorsley Common BUA","E34002813","Total",616,299,317,602,14,12,46.50,13.2
"2011","Tangmere BUA","E34002814","Total",3269,1508,1761,3269,0,48,153.50,21.3
"2011","Coverack BUA","E34002815","Total",255,132,123,255,0,5,22.25,11.5
"2011","Dereham BUA","E34002816","Total",20651,9979,10672,20362,289,203,636.50,32.4
"2011","Fringford BUA","E34002817","Total",602,284,318,602,0,13,27.50,21.9
"2011","Great Yeldham BUA","E34002818","Total",1844,919,925,1841,3,12,69.00,26.7
"2011","Everton (Bassetlaw) BUA","E34002819","Total",591,302,289,591,0,20,36.50,16.2
"2011","Shrewsbury BUA","E34002820","Total",71715,35434,36281,69929,1786,1074,2148.51,33.4
"2011","Carkeel BUA","E34002821","Total",317,160,157,317,0,6,23.00,13.8
"2011","Groombridge BUA","E34002822","Total",1120,533,587,1120,0,22,62.00,18.1
"2011","Roade BUA","E34002823","Total",2312,1112,1200,2312,0,41,92.25,25.1
"2011","Misson BUA","E34002824","Total",745,374,371,745,0,25,33.75,22.1
"2011","Garthorpe BUA","E34002825","Total",418,212,206,418,0,0,35.25,11.9
"2011","Witley BUA","E34002826","Total",6437,3060,3377,6437,0,97,226.00,28.5
"2011","Shalfleet BUA","E34002827","Total",605,295,310,605,0,4,20.75,29.2
"2011","Barton (Richmondshire) BUA","E34002828","Total",837,405,432,837,0,19,35.00,23.9
"2011","Hurworth-on-Tees BUA","E34002829","Total",2797,1353,1444,2784,13,61,99.75,28.0
"2011","Beadnell BUA","E34002830","Total",408,208,200,407,1,7,38.75,10.5
"2011","Burghwallis BUA","E34002831","Total",300,155,145,285,15,4,21.00,14.3
"2011","North Leverton with Habblesthorpe BUA","E34002832","Total",1047,493,554,1047,0,10,52.75,19.8
"2011","Haddiscoe BUA","E34002833","Total",375,192,183,375,0,6,21.00,17.9
"2011","Storrs BUA","E34002834","Total",323,155,168,294,29,2,31.00,10.4
"2011","Westoning BUA","E34002835","Total",2147,1086,1061,2131,16,39,55.00,39.0
"2011","Ambrosden BUA","E34002836","Total",1662,810,852,1660,2,30,48.50,34.3
"2011","Biddenden BUA","E34002837","Total",1303,626,677,1303,0,27,53.75,24.2
"2011","Burghclere BUA","E34002838","Total",546,290,256,515,31,9,48.00,11.4
"2011","Godshill (New Forest) BUA","E34002839","Total",436,217,219,436,0,12,47.50,9.2
"2011","King's Cliffe BUA","E34002840","Total",1202,579,623,1202,0,28,50.00,24.0
"2011","Buckland Dinham BUA","E34002841","Total",381,190,191,381,0,6,21.25,17.9
"2011","Chiseldon BUA","E34002842","Total",2090,1018,1072,2071,19,29,77.00,27.1
"2011","Felthorpe BUA","E34002843","Total",600,291,309,598,2,7,44.50,13.5
"2011","Inkberrow BUA","E34002844","Total",1552,773,779,1552,0,34,78.50,19.8
"2011","Trimingham BUA","E34002845","Total",485,242,243,470,15,6,24.00,20.2
"2011","Newbourne BUA","E34002846","Total",304,155,149,304,0,11,68.50,4.4
"2011","Curbridge BUA","E34002847","Total",529,285,244,529,0,4,26.75,19.8
"2011","Upper Basildon BUA","E34002848","Total",1405,727,678,1405,0,50,108.50,12.9
"2011","Blaxton BUA","E34002849","Total",841,415,426,841,0,7,35.00,24.0
"2011","High Kelling BUA","E34002850","Total",536,243,293,498,38,11,45.50,11.8
"2011","Frankton BUA","E34002851","Total",351,171,180,351,0,12,22.75,15.4
"2011","Ruyton-XI-Towns BUA","E34002852","Total",1040,542,498,906,134,27,47.75,21.8
"2011","Sedbergh BUA","E34002853","Total",2171,1139,1032,1726,445,41,73.25,29.6
"2011","Newport (Telford and Wrekin) BUA","E34002854","Total",12741,6342,6399,12505,236,233,320.25,39.8
"2011","Baydon BUA","E34002855","Total",664,331,333,661,3,19,33.00,20.1
"2011","Baston BUA","E34002856","Total",1444,695,749,1444,0,45,53.75,26.9
"2011","Willersey BUA","E34002857","Total",816,385,431,814,2,16,44.50,18.3
"2011","Lower Heyford BUA","E34002858","Total",233,111,122,233,0,0,22.25,10.5
"2011","Laxfield BUA","E34002859","Total",910,468,442,910,0,18,31.75,28.7
"2011","Great Barton (East) BUA","E34002860","Total",261,128,133,261,0,4,30.75,8.5
"2011","Alconbury BUA","E34002861","Total",1569,764,805,1569,0,21,52.25,30.0
"2011","Shudy Camps BUA","E34002862","Total",338,171,167,326,12,15,20.50,16.5
"2011","Alveley BUA","E34002863","Total",1578,771,807,1578,0,28,64.50,24.5
"2011","Langtoft (South Kesteven) BUA","E34002864","Total",2045,1018,1027,2045,0,50,66.75,30.6
"2011","Great Broughton (Hambleton) BUA","E34002865","Total",841,402,439,840,1,11,49.75,16.9
"2011","Heads Nook BUA","E34002866","Total",341,176,165,341,0,6,23.50,14.5
"2011","Brock Hill BUA","E34002867","Total",390,209,181,390,0,4,20.75,18.8
"2011","Marhamchurch BUA","E34002868","Total",658,314,344,652,6,15,28.75,22.9
"2011","Slindon BUA","E34002869","Total",289,162,127,246,43,3,26.75,10.8
"2011","Northwood BUA","E34002870","Total",270,133,137,270,0,1,29.50,9.2
"2011","Elford BUA","E34002871","Total",632,325,307,632,0,8,28.75,22.0
"2011","Beaconsfield BUA","E34002872","Total",13797,6644,7153,13676,121,463,634.25,21.8
"2011","Rickinghall BUA","E34002873","Total",2073,1010,1063,2071,2,35,78.50,26.4
"2011","Rettendon BUA","E34002874","Total",448,224,224,448,0,2,30.50,14.7
"2011","Niton BUA","E34002875","Total",1162,568,594,1160,2,20,82.75,14.0
"2011","Ludham BUA","E34002876","Total",979,475,504,953,26,4,49.25,19.9
"2011","Croesowallt BUA","E34002877","Total",18743,9097,9646,18425,318,213,567.50,33.0
"2011","Chapel-en-le-Frith BUA","E34002878","Total",6598,3209,3389,6482,116,96,202.75,32.5
"2011","Woodborough (Wiltshire) BUA","E34002879","Total",292,139,153,292,0,6,24.75,11.8
"2011","Chedburgh BUA","E34002880","Total",597,293,304,597,0,9,42.50,14.0
"2011","Stonham Aspal BUA","E34002881","Total",237,128,109,237,0,8,32.25,7.3
"2011","Woodseaves BUA","E34002882","Total",686,334,352,686,0,9,24.00,28.6
"2011","Greatworth BUA","E34002883","Total",708,349,359,708,0,17,26.25,27.0
"2011","Strangways BUA","E34002884","Total",204,108,96,204,0,22,28.75,7.1
"2011","Shimpling Street BUA","E34002885","Total",431,213,218,431,0,16,20.75,20.8
"2011","Kilham BUA","E34002886","Total",960,454,506,960,0,12,57.00,16.8
"2011","Ravensthorpe BUA","E34002887","Total",646,320,326,646,0,24,33.25,19.4
"2011","Godstone BUA","E34002888","Total",2564,1197,1367,2509,55,22,81.25,31.6
"2011","Ridge BUA","E34002889","Total",289,140,149,289,0,5,20.75,13.9
"2011","Brook BUA","E34002890","Total",310,153,157,310,0,7,29.25,10.6
"2011","Aston (West Oxfordshire) BUA","E34002891","Total",1109,555,554,1109,0,29,36.50,30.4
"2011","High Halstow BUA","E34002892","Total",1662,799,863,1662,0,29,53.75,30.9
"2011","Hampstead Norreys BUA","E34002893","Total",628,338,290,628,0,14,32.25,19.5
"2011","Norton (Isle of Wight) BUA","E34002894","Total",215,101,114,214,1,3,43.00,5.0
"2011","Chorlton BUA","E34002895","Total",346,176,170,346,0,8,22.25,15.6
"2011","Forncett End BUA","E34002896","Total",1027,517,510,1006,21,20,63.00,16.3
"2011","Hopwas BUA","E34002897","Total",647,318,329,647,0,6,31.75,20.4
"2011","Cubert BUA","E34002898","Total",771,378,393,771,0,13,28.25,27.3
"2011","Fernhill Heath BUA","E34002899","Total",3256,1621,1635,3220,36,59,96.00,33.9
"2011","Brookenby BUA","E34002900","Total",665,328,337,665,0,8,45.25,14.7
"2011","Mickleham BUA","E34002901","Total",585,296,289,434,151,23,22.25,26.3
"2011","Appleby-in-Westmorland BUA","E34002902","Total",3048,1476,1572,2980,68,50,112.00,27.2
"2011","Willingham BUA","E34002903","Total",4015,1991,2024,4013,2,68,163.25,24.6
"2011","Tansley BUA","E34002904","Total",1197,612,585,1180,17,33,71.00,16.9
"2011","Papworth Everard BUA","E34002905","Total",2880,1387,1493,2864,16,32,108.50,26.5
"2011","Longridge BUA","E34002906","Total",7526,3591,3935,7416,110,90,208.50,36.1
"2011","Ropsley BUA","E34002907","Total",647,312,335,647,0,8,34.25,18.9
"2011","Newton on Trent BUA","E34002908","Total",389,193,196,389,0,6,22.00,17.7
"2011","Sleights BUA","E34002909","Total",1972,916,1056,1959,13,33,107.75,18.3
"2011","South Walsham BUA","E34002910","Total",414,194,220,414,0,9,23.25,17.8
"2011","Sockbridge BUA","E34002911","Total",415,192,223,413,2,11,28.00,14.8
"2011","East Cowton BUA","E34002912","Total",533,265,268,533,0,16,27.50,19.4
"2011","Warwick Bridge BUA","E34002913","Total",1264,603,661,1264,0,22,38.25,33.0
"2011","Bozeat BUA","E34002914","Total",2052,1012,1040,2036,16,18,58.75,34.9
"2011","Hogpits Bottom BUA","E34002915","Total",298,136,162,298,0,8,24.50,12.2
"2011","Coton in the Elms BUA","E34002916","Total",896,437,459,896,0,12,26.00,34.5
"2011","Verwood BUA","E34002917","Total",13360,6481,6879,13341,19,146,434.00,30.8
"2011","Willoughby-on-the-Wolds BUA","E34002918","Total",572,273,299,572,0,3,33.75,16.9
"2011","Alexandra Park BUA","E34002919","Total",658,323,335,658,0,24,23.00,28.6
"2011","Uppingham BUA","E34002920","Total",4745,2380,2365,3763,982,98,120.75,39.3
"2011","Sutton Bonington BUA","E34002921","Total",1218,597,621,1217,1,22,46.25,26.3
"2011","Sproatley BUA","E34002922","Total",1350,662,688,1350,0,19,40.75,33.1
"2011","Little Weighton BUA","E34002923","Total",1015,478,537,986,29,27,42.75,23.7
"2011","Austwick BUA","E34002924","Total",463,223,240,459,4,14,20.50,22.6
"2011","Chapmanslade BUA","E34002925","Total",643,313,330,643,0,27,37.25,17.3
"2011","Swarland BUA","E34002926","Total",634,312,322,634,0,13,60.00,10.6
"2011","Whitchurch (Shropshire) BUA","E34002927","Total",9710,4783,4927,9557,153,102,289.50,33.5
"2011","Habrough BUA","E34002928","Total",631,320,311,631,0,9,21.00,30.0
"2011","Upavon BUA","E34002929","Total",474,234,240,474,0,9,27.25,17.4
"2011","Child's Ercall BUA","E34002930","Total",418,221,197,418,0,8,21.50,19.4
"2011","Barford St Michael BUA","E34002931","Total",549,271,278,549,0,22,27.75,19.8
"2011","Marsh Gibbon BUA","E34002932","Total",969,480,489,969,0,26,60.25,16.1
"2011","Shurlock Row BUA","E34002933","Total",295,146,149,295,0,13,30.25,9.8
"2011","Harston BUA","E34002934","Total",1729,872,857,1729,0,37,96.50,17.9
"2011","Washford BUA","E34002935","Total",601,274,327,601,0,11,26.50,22.7
"2011","Great Dalby BUA","E34002936","Total",562,290,272,562,0,14,34.50,16.3
"2011","Burton Leonard BUA","E34002937","Total",690,335,355,690,0,18,30.50,22.6
"2011","Hermitage BUA","E34002938","Total",2157,1107,1050,2021,136,34,97.50,22.1
"2011","Bugbrooke BUA","E34002939","Total",2692,1306,1386,2692,0,59,80.00,33.6
"2011","East Knoyle BUA","E34002940","Total",335,167,168,335,0,12,30.75,10.9
"2011","Cottered BUA","E34002941","Total",451,223,228,451,0,7,44.50,10.1
"2011","Crosby BUA","E34002942","Total",816,402,414,816,0,3,34.50,23.7
"2011","East Keal BUA","E34002943","Total",366,183,183,366,0,7,38.25,9.6
"2011","Hedenham BUA","E34002944","Total",240,120,120,240,0,7,21.25,11.3
"2011","Newton Arlosh BUA","E34002945","Total",318,164,154,318,0,3,20.50,15.5
"2011","Cropwell Butler BUA","E34002946","Total",357,169,188,357,0,11,29.25,12.2
"2011","Lyddington BUA","E34002947","Total",366,177,189,366,0,13,35.00,10.5
"2011","East Harptree BUA","E34002948","Total",644,320,324,644,0,30,36.75,17.5
"2011","Stanhope BUA","E34002949","Total",1602,796,806,1558,44,23,63.00,25.4
"2011","Dorney Reach BUA","E34002950","Total",474,221,253,474,0,8,30.50,15.5
"2011","Churt Lea BUA","E34002951","Total",229,110,119,229,0,8,43.50,5.3
"2011","Hanslope BUA","E34002952","Total",1916,967,949,1916,0,26,54.75,35.0
"2011","Settle BUA","E34002953","Total",3659,1770,1889,3406,253,79,137.50,26.6
"2011","Pengersick BUA","E34002954","Total",229,104,125,229,0,2,27.75,8.3
"2011","Hambridge BUA","E34002955","Total",250,122,128,250,0,6,20.25,12.3
"2011","Weston-on-Trent BUA","E34002956","Total",761,365,396,761,0,28,32.25,23.6
"2011","Charlbury BUA","E34002957","Total",2830,1371,1459,2829,1,91,100.50,28.2
"2011","Austrey BUA","E34002958","Total",928,461,467,928,0,35,34.50,26.9
"2011","Merstone BUA","E34002959","Total",324,149,175,324,0,7,23.75,13.6
"2011","Barford (South Norfolk) BUA","E34002960","Total",547,264,283,547,0,8,36.00,15.2
"2011","Folkingham BUA","E34002961","Total",796,361,435,784,12,10,35.00,22.7
"2011","Hockliffe BUA","E34002962","Total",823,412,411,823,0,10,28.75,28.6
"2011","Tidworth BUA","E34002963","Total",9174,5668,3506,6827,2347,130,291.00,31.5
"2011","Churton BUA","E34002964","Total",365,184,181,365,0,7,25.00,14.6
"2011","Redmarley D'Abitot BUA","E34002965","Total",366,175,191,342,24,10,21.75,16.8
"2011","Holt (Wiltshire) BUA","E34002966","Total",1757,869,888,1719,38,44,69.00,25.5
"2011","Alford BUA","E34002967","Total",3459,1620,1839,3397,62,31,124.75,27.7
"2011","Teynham BUA","E34002968","Total",2687,1308,1379,2675,12,18,74.75,35.9
"2011","Kintbury BUA","E34002969","Total",2094,1039,1055,2075,19,46,100.25,20.9
"2011","Acton Burnell BUA","E34002970","Total",544,274,270,203,341,13,22.25,24.4
"2011","Bracebridge Heath BUA","E34002971","Total",5656,2753,2903,5656,0,77,155.25,36.4
"2011","Wragby BUA","E34002972","Total",1768,854,914,1768,0,14,70.25,25.2
"2011","Thorngumbald BUA","E34002973","Total",2973,1497,1476,2957,16,30,95.50,31.1
"2011","Wymeswold BUA","E34002974","Total",1296,627,669,1277,19,31,47.25,27.4
"2011","Milcombe BUA","E34002975","Total",613,308,305,613,0,10,23.25,26.4
"2011","Borden BUA","E34002976","Total",741,363,378,741,0,18,47.75,15.5
"2011","Cropwell Bishop BUA","E34002977","Total",1853,931,922,1807,46,31,48.50,38.2
"2011","Uphampton BUA","E34002978","Total",348,181,167,348,0,4,25.25,13.8
"2011","Newton Longville BUA","E34002979","Total",1846,905,941,1837,9,37,61.00,30.3
"2011","Newton (North Dorset) BUA","E34002980","Total",272,137,135,272,0,5,22.00,12.4
"2011","Deanshanger BUA","E34002981","Total",3817,1875,1942,3816,1,49,86.50,44.1
"2011","Harman's Cross BUA","E34002982","Total",363,186,177,360,3,11,38.75,9.4
"2011","Capel St Mary BUA","E34002983","Total",2734,1354,1380,2734,0,42,106.50,25.7
"2011","Middleton-in-Teesdale BUA","E34002984","Total",934,458,476,931,3,8,41.50,22.5
"2011","Kirk Smeaton BUA","E34002985","Total",688,353,335,688,0,4,41.50,16.6
"2011","Hawthorn BUA","E34002986","Total",500,256,244,500,0,5,20.75,24.1
"2011","Thorndon BUA","E34002987","Total",648,311,337,648,0,15,46.25,14.0
"2011","Primrose Valley BUA","E34002988","Total",451,232,219,451,0,6,23.50,19.2
"2011","Breedon on the Hill BUA","E34002989","Total",686,344,342,686,0,18,35.00,19.6
"2011","Chacewater BUA","E34002990","Total",1226,588,638,1226,0,5,31.75,38.6
"2011","Warborough BUA","E34002991","Total",987,489,498,987,0,33,61.50,16.0
"2011","Orwell Meadows Caravan Site BUA","E34002992","Total",343,185,158,290,53,4,21.75,15.8
"2011","Barton-upon-Humber BUA","E34002993","Total",11066,5380,5686,10963,103,109,319.00,34.7
"2011","Horsley BUA","E34002994","Total",420,199,221,420,0,11,23.25,18.1
"2011","Dunham-on-the-Hill BUA","E34002995","Total",501,260,241,501,0,9,29.50,17.0
"2011","Onley BUA","E34002996","Total",1381,1226,155,303,1078,3,29.75,46.4
"2011","Lower Stoke BUA","E34002997","Total",766,386,380,766,0,8,21.75,35.2
"2011","Huncote BUA","E34002998","Total",1756,843,913,1739,17,26,38.75,45.3
"2011","Croxton Kerrial BUA","E34002999","Total",530,258,272,530,0,5,23.00,23.0
"2011","Old Bolingbroke BUA","E34003000","Total",325,165,160,325,0,11,33.00,9.8
"2011","Silk Willoughby BUA","E34003001","Total",299,148,151,299,0,7,23.75,12.6
"2011","Upper Minety BUA","E34003002","Total",278,143,135,278,0,10,22.50,12.4
"2011","Flamborough BUA","E34003003","Total",1914,933,981,1911,3,15,75.25,25.4
"2011","Sevenoaks Weald BUA","E34003004","Total",805,385,420,805,0,32,35.25,22.8
"2011","Burnopfield BUA","E34003005","Total",3735,1830,1905,3689,46,36,88.00,42.4
"2011","Normanby-by-Spital BUA","E34003006","Total",790,410,380,790,0,17,42.00,18.8
"2011","West Deeping BUA","E34003007","Total",255,127,128,255,0,10,23.25,11.0
"2011","Aylsham BUA","E34003008","Total",6016,2854,3162,5949,67,90,225.75,26.6
"2011","Melbourne (East Riding of Yorkshire) BUA","E34003009","Total",793,391,402,793,0,22,41.00,19.3
"2011","Needingworth BUA","E34003010","Total",2191,1095,1096,2191,0,39,71.75,30.5
"2011","Myerscough BUA","E34003011","Total",520,323,197,202,318,33,27.00,19.3
"2011","Spaxton BUA","E34003012","Total",321,154,167,321,0,5,22.75,14.1
"2011","Kingskerswell BUA","E34003013","Total",4703,2272,2431,4683,20,63,142.25,33.1
"2011","Peasemore BUA","E34003014","Total",311,156,155,311,0,17,22.25,14.0
"2011","Nether Heyford BUA","E34003015","Total",1637,776,861,1637,0,25,52.50,31.2
"2011","Badsworth BUA","E34003016","Total",682,341,341,682,0,15,34.00,20.1
"2011","Chart Sutton BUA","E34003017","Total",496,245,251,496,0,14,25.00,19.8
"2011","Georgeham BUA","E34003018","Total",467,222,245,467,0,12,28.00,16.7
"2011","Halton BUA","E34003019","Total",2056,969,1087,2023,33,34,66.00,31.2
"2011","East Rudham BUA","E34003020","Total",541,263,278,541,0,13,36.25,14.9
"2011","Poringland BUA","E34003021","Total",5132,2485,2647,5107,25,71,207.25,24.8
"2011","Charlesworth BUA","E34003022","Total",990,476,514,990,0,20,51.25,19.3
"2011","Gnosall BUA","E34003023","Total",3869,1906,1963,3859,10,73,113.50,34.1
"2011","Manningtree BUA","E34003024","Total",5696,2694,3002,5674,22,64,171.75,33.2
"2011","Croscombe BUA","E34003025","Total",603,298,305,603,0,12,25.50,23.6
"2011","Longburton BUA","E34003026","Total",470,233,237,470,0,18,30.25,15.5
"2011","Boughton Under Blean BUA","E34003027","Total",2197,1073,1124,2197,0,23,65.75,33.4
"2011","Gedney BUA","E34003028","Total",311,160,151,311,0,3,25.25,12.3
"2011","Keynsham BUA","E34003029","Total",15641,7473,8168,15490,151,188,397.25,39.4
"2011","Damerham BUA","E34003030","Total",225,106,119,225,0,0,20.75,10.8
"2011","Long Bennington BUA","E34003031","Total",2018,958,1060,2004,14,46,98.25,20.5
"2011","Martock BUA","E34003032","Total",4522,2180,2342,4478,44,56,140.00,32.3
"2011","Kinsham BUA","E34003033","Total",321,160,161,321,0,9,23.50,13.7
"2011","Tibberton (Telford and Wrekin) BUA","E34003034","Total",525,276,249,525,0,19,38.75,13.5
"2011","Barrowby BUA","E34003035","Total",1952,954,998,1933,19,34,77.50,25.2
"2011","Kinver BUA","E34003036","Total",4723,2269,2454,4699,24,101,186.25,25.4
"2011","Feniton BUA","E34003037","Total",1568,780,788,1568,0,13,40.75,38.5
"2011","Elwick BUA","E34003038","Total",479,222,257,479,0,2,26.25,18.2
"2011","Honeybourne BUA","E34003039","Total",1388,683,705,1388,0,17,50.00,27.8
"2011","Upstreet BUA","E34003040","Total",607,304,303,558,49,5,28.25,21.5
"2011","Great Ellingham BUA","E34003041","Total",856,447,409,856,0,9,57.00,15.0
"2011","Kingsley (Cheshire West and Chester) BUA","E34003042","Total",1557,762,795,1557,0,45,66.25,23.5
"2011","Grimston BUA","E34003043","Total",2086,1005,1081,2082,4,32,123.25,16.9
"2011","Caddington BUA","E34003044","Total",3112,1501,1611,3112,0,38,78.50,39.6
"2011","Culgaith BUA","E34003045","Total",391,197,194,386,5,7,25.50,15.3
"2011","Fontmell Magna BUA","E34003046","Total",333,162,171,333,0,8,36.75,9.1
"2011","South Tehidy BUA","E34003047","Total",1093,515,578,1093,0,11,52.50,20.8
"2011","Hinderwell BUA","E34003048","Total",618,316,302,618,0,16,28.75,21.5
"2011","Old Buckenham BUA","E34003049","Total",792,379,413,792,0,21,43.75,18.1
"2011","Point Clear BUA","E34003050","Total",1576,789,787,1550,26,9,122.25,12.9
"2011","Compton Dundon BUA","E34003051","Total",354,171,183,354,0,5,26.25,13.5
"2011","Newton Tony BUA","E34003052","Total",381,197,184,381,0,8,32.00,11.9
"2011","Headcorn BUA","E34003053","Total",2505,1190,1315,2494,11,25,79.00,31.7
"2011","Canwick BUA","E34003054","Total",324,156,168,310,14,10,24.75,13.1
"2011","Chawleigh BUA","E34003055","Total",642,325,317,618,24,7,24.75,25.9
"2011","Northend BUA","E34003056","Total",274,142,132,274,0,1,22.75,12.0
"2011","Wolverhampton Airport BUA","E34003057","Total",355,181,174,355,0,8,128.75,2.8
"2011","Cottesmore BUA","E34003058","Total",1067,521,546,1067,0,19,40.75,26.2
"2011","Ilton BUA","E34003059","Total",727,348,379,727,0,8,36.75,19.8
"2011","Waddington BUA","E34003060","Total",1028,500,528,1028,0,13,28.75,35.8
"2011","Glemsford BUA","E34003061","Total",3382,1704,1678,3367,15,32,92.00,36.8
"2011","Burstall BUA","E34003063","Total",198,94,104,198,0,2,20.25,9.8
"2011","Ludford BUA","E34003064","Total",460,231,229,460,0,5,25.50,18.0
"2011","Martinstown BUA","E34003065","Total",486,219,267,465,21,10,30.75,15.8
"2011","Howsham BUA","E34003066","Total",459,233,226,457,2,8,23.75,19.3
"2011","Freiston BUA","E34003067","Total",348,174,174,348,0,6,24.00,14.5
"2011","Long Whatton BUA","E34003068","Total",1124,540,584,1123,1,22,56.75,19.8
"2011","Dousland BUA","E34003069","Total",833,394,439,814,19,20,49.00,17.0
"2011","Herstmonceux BUA","E34003070","Total",1130,541,589,1122,8,10,34.25,33.0
"2011","Sleaford BUA","E34003071","Total",17359,8409,8950,17239,120,239,497.75,34.9
"2011","Clifton Campville BUA","E34003072","Total",634,327,307,632,2,8,24.25,26.1
"2011","Horsford BUA","E34003073","Total",4163,2049,2114,4072,91,43,123.75,33.6
"2011","Ranskill BUA","E34003074","Total",1362,657,705,1362,0,27,65.50,20.8
"2011","Coxhoe BUA","E34003075","Total",3522,1738,1784,3516,6,36,84.25,41.8
"2011","West Meon BUA","E34003076","Total",724,362,362,716,8,28,31.75,22.8
"2011","Great Stukeley BUA","E34003077","Total",720,356,364,720,0,15,36.75,19.6
"2011","Barrow-in-Furness BUA","E34003078","Total",45865,22776,23089,45306,559,503,1210.00,37.9
"2011","Lodsworth BUA","E34003079","Total",348,162,186,348,0,16,36.25,9.6
"2011","Chipping BUA","E34003080","Total",618,301,317,618,0,7,28.75,21.5
"2011","Blackboys BUA","E34003081","Total",311,152,159,311,0,3,28.00,11.1
"2011","Wellesbourne BUA","E34003082","Total",5849,2782,3067,5836,13,79,312.25,18.7
"2011","Seaton (Rutland) BUA","E34003083","Total",250,119,131,250,0,20,21.25,11.8
"2011","Bosham BUA","E34003084","Total",2623,1267,1356,2614,9,72,137.00,19.1
"2011","Houghton on the Hill BUA","E34003085","Total",1524,759,765,1524,0,42,52.50,29.0
"2011","Ewerby BUA","E34003086","Total",509,248,261,477,32,7,23.00,22.1
"2011","Kingston Blount BUA","E34003087","Total",506,245,261,506,0,16,23.25,21.8
"2011","Harlaxton BUA","E34003088","Total",782,372,410,782,0,5,47.50,16.5
"2011","Albury BUA","E34003089","Total",574,293,281,548,26,12,30.75,18.7
"2011","North Kelsey BUA","E34003090","Total",777,378,399,777,0,18,50.50,15.4
"2011","Ford End BUA","E34003091","Total",685,358,327,685,0,12,23.00,29.8
"2011","South Leverton BUA","E34003092","Total",480,234,246,474,6,11,40.25,11.9
"2011","Auckley BUA","E34003093","Total",1434,694,740,1434,0,37,50.50,28.4
"2011","Braithwaite BUA","E34003094","Total",342,161,181,338,4,5,34.00,10.1
"2011","Winterborne Kingston BUA","E34003095","Total",643,325,318,643,0,9,30.75,20.9
"2011","Manuden BUA","E34003096","Total",677,342,335,677,0,12,31.25,21.7
"2011","Wookey Hole BUA","E34003097","Total",324,159,165,323,1,7,26.75,12.1
"2011","Clowne BUA","E34003098","Total",7590,3736,3854,7515,75,60,232.25,32.7
"2011","Hough BUA","E34003099","Total",808,410,398,808,0,9,33.00,24.5
"2011","Albourne BUA","E34003100","Total",310,160,150,310,0,5,24.50,12.7
"2011","Merry Lees BUA","E34003101","Total",142,70,72,142,0,4,26.00,5.5
"2011","Chatteris BUA","E34003102","Total",10298,5082,5216,10259,39,97,299.25,34.4
"2011","Dishforth Airfield BUA","E34003103","Total",523,349,174,332,191,5,109.00,4.8
"2011","Brixham BUA","E34003104","Total",16693,7968,8725,16468,225,124,425.25,39.3
"2011","Pitton BUA","E34003105","Total",510,254,256,510,0,16,22.25,22.9
"2011","Houghton (Test Valley) BUA","E34003106","Total",341,171,170,341,0,8,40.50,8.4
"2011","Robin Hood's Bay BUA","E34003107","Total",457,214,243,415,42,8,48.00,9.5
"2011","Iden BUA","E34003108","Total",456,215,241,456,0,4,40.00,11.4
"2011","Murton (County Durham) BUA","E34003109","Total",7413,3621,3792,7322,91,28,153.75,48.2
"2011","Dittisham BUA","E34003110","Total",226,111,115,226,0,6,32.75,6.9
"2011","Bosbury BUA","E34003111","Total",234,114,120,234,0,7,23.25,10.1
"2011","Tiverton BUA","E34003112","Total",19544,9485,10059,19217,327,176,548.25,35.6
"2011","Tarrington BUA","E34003113","Total",576,284,292,559,17,10,20.25,28.4
"2011","Potton BUA","E34003114","Total",4870,2415,2455,4870,0,64,142.75,34.1
"2011","Stogursey BUA","E34003115","Total",838,430,408,838,0,9,28.00,29.9
"2011","West Runton BUA","E34003116","Total",815,395,420,794,21,10,70.25,11.6
"2011","Derrington BUA","E34003117","Total",668,329,339,664,4,8,22.00,30.4
"2011","Kington Langley BUA","E34003118","Total",841,404,437,810,31,18,61.75,13.6
"2011","East Challow BUA","E34003119","Total",769,388,381,769,0,13,30.50,25.2
"2011","Hornton BUA","E34003120","Total",328,165,163,328,0,7,21.25,15.4
"2011","Churchill (West Oxfordshire) BUA","E34003121","Total",429,212,217,429,0,11,31.00,13.8
"2011","Kirkhamgate BUA","E34003122","Total",992,472,520,992,0,16,39.75,25.0
"2011","Lower Quinton BUA","E34003123","Total",1968,942,1026,1934,34,19,41.25,47.7
"2011","Hurstpierpoint BUA","E34003124","Total",12730,6053,6677,12654,76,188,408.75,31.1
"2011","Little Melton BUA","E34003125","Total",897,430,467,897,0,18,50.25,17.9
"2011","Shalbourne BUA","E34003126","Total",558,283,275,555,3,27,39.75,14.0
"2011","Hogsthorpe BUA","E34003127","Total",908,454,454,889,19,6,34.00,26.7
"2011","Madley BUA","E34003128","Total",712,349,363,712,0,14,31.25,22.8
"2011","South Hayling BUA","E34003129","Total",15485,7434,8051,15102,383,130,473.75,32.7
"2011","Adderbury BUA","E34003130","Total",2819,1352,1467,2775,44,50,116.00,24.3
"2011","Belton-in-Rutland BUA","E34003131","Total",348,167,181,334,14,10,21.75,16.0
"2011","Highnam BUA","E34003132","Total",1707,824,883,1707,0,53,55.00,31.0
"2011","Foulden BUA","E34003133","Total",430,219,211,430,0,5,29.00,14.8
"2011","Harleston BUA","E34003134","Total",4458,2139,2319,4428,30,33,145.00,30.7
"2011","Norton (Arun) BUA","E34003135","Total",313,155,158,313,0,10,21.50,14.6
"2011","Okeford Fitzpaine BUA","E34003136","Total",737,353,384,737,0,7,35.25,20.9
"2011","Winscombe BUA","E34003137","Total",4546,2171,2375,4255,291,82,244.00,18.6
"2011","Horningsea BUA","E34003138","Total",378,194,184,378,0,6,23.50,16.1
"2011","Highpoint Prison BUA","E34003139","Total",1528,1330,198,376,1152,14,32.50,47.0
"2011","Braughing BUA","E34003140","Total",854,417,437,854,0,19,55.50,15.4
"2011","Husbands Bosworth BUA","E34003141","Total",1027,488,539,978,49,14,33.00,31.1
"2011","Burton Bradstock BUA","E34003142","Total",682,308,374,682,0,10,51.50,13.2
"2011","Scruton BUA","E34003143","Total",424,216,208,424,0,9,24.50,17.3
"2011","Bamburgh BUA","E34003144","Total",279,138,141,276,3,4,27.25,10.2
"2011","Hatfield Heath BUA","E34003145","Total",1717,820,897,1696,21,32,84.75,20.3
"2011","Baslow BUA","E34003146","Total",1178,552,626,1172,6,37,78.00,15.1
"2011","Allhallows-on-Sea BUA","E34003147","Total",1446,716,730,1422,24,14,53.50,27.0
"2011","Cosgrove BUA","E34003148","Total",521,262,259,520,1,11,27.00,19.3
"2011","Margaretting BUA","E34003149","Total",527,257,270,527,0,10,41.75,12.6
"2011","Barrington (South Somerset) BUA","E34003150","Total",438,202,236,438,0,7,35.00,12.5
"2011","Lakenheath BUA","E34003151","Total",4369,2199,2170,4351,18,27,163.25,26.8
"2011","Flimby BUA","E34003152","Total",1707,859,848,1704,3,12,53.75,31.8
"2011","Bishop's Castle BUA","E34003153","Total",1893,915,978,1775,118,29,82.75,22.9
"2011","Egremont BUA","E34003154","Total",6222,3068,3154,6184,38,49,172.25,36.1
"2011","Walton BUA","E34003155","Total",600,297,303,600,0,13,22.25,27.0
"2011","Silloth BUA","E34003156","Total",2906,1353,1553,2795,111,21,180.75,16.1
"2011","Cheadle Road, nr Cheddleton BUA","E34003157","Total",463,225,238,459,4,5,21.75,21.3
"2011","High Melton BUA","E34003158","Total",300,146,154,297,3,5,21.25,14.1
"2011","Wheelock Heath BUA","E34003159","Total",1197,573,624,1197,0,35,59.75,20.0
"2011","Byfield BUA","E34003160","Total",1277,625,652,1251,26,28,47.75,26.7
"2011","Burgh le Marsh BUA","E34003161","Total",2026,963,1063,2013,13,23,86.00,23.6
"2011","Sopley BUA","E34003162","Total",308,154,154,246,62,4,24.50,12.6
"2011","Ampleforth BUA","E34003163","Total",705,369,336,656,49,14,41.50,17.0
"2011","Westbury (Shropshire) BUA","E34003164","Total",657,313,344,657,0,12,26.25,25.0
"2011","Swaffham BUA","E34003165","Total",7258,3359,3899,7001,257,53,249.75,29.1
"2011","Alanbrooke Barracks BUA","E34003166","Total",773,519,254,515,258,7,166.50,4.6
"2011","Coundon BUA","E34003167","Total",3256,1617,1639,3226,30,16,86.00,37.9
"2011","Ledbury BUA","E34003168","Total",8862,4259,4603,8804,58,95,256.75,34.5
"2011","Letcombe Regis BUA","E34003169","Total",578,272,306,525,53,23,40.00,14.4
"2011","Holme (South Lakeland) BUA","E34003170","Total",1375,666,709,1374,1,13,48.75,28.2
"2011","Landkey BUA","E34003171","Total",1732,808,924,1732,0,24,57.75,30.0
"2011","Earls Colne BUA","E34003172","Total",3862,1825,2037,3748,114,46,140.25,27.5
"2011","Sennen Cove BUA","E34003173","Total",410,200,210,404,6,2,33.00,12.4
"2011","Skipton BUA","E34003174","Total",14623,7003,7620,14564,59,231,381.75,38.3
"2011","Andoversford BUA","E34003175","Total",555,294,261,555,0,9,28.00,19.8
"2011","Ashton (South Northamptonshire) BUA","E34003176","Total",395,207,188,395,0,14,20.25,19.5
"2011","University of Essex BUA","E34003177","Total",2388,1149,1239,263,2125,53,22.75,105.0
"2011","Bradford on Avon BUA","E34003178","Total",9149,4307,4842,9133,16,178,265.75,34.4
"2011","Hingham BUA","E34003179","Total",2151,1033,1118,2118,33,26,101.75,21.1
"2011","Offwell BUA","E34003180","Total",408,195,213,408,0,11,24.00,17.0
"2011","Ardington BUA","E34003181","Total",301,145,156,301,0,5,23.50,12.8
"2011","Etton BUA","E34003182","Total",277,142,135,277,0,13,23.00,12.0
"2011","Fulstow BUA","E34003183","Total",522,257,265,522,0,8,29.00,18.0
"2011","Woodhurst BUA","E34003184","Total",379,199,180,377,2,4,21.25,17.8
"2011","Rothbury BUA","E34003185","Total",2326,1130,1196,2314,12,31,104.50,22.3
"2011","Kirtlington BUA","E34003186","Total",988,472,516,988,0,28,38.25,25.8
"2011","Sproughton BUA","E34003187","Total",772,378,394,772,0,3,31.25,24.7
"2011","Woodchurch BUA","E34003188","Total",1074,532,542,1074,0,19,60.75,17.7
"2011","Hascombe (North) BUA","E34003189","Total",528,258,270,458,70,26,61.00,8.7
"2011","Chilmark BUA","E34003190","Total",525,254,271,525,0,17,33.75,15.6
"2011","Bilsby BUA","E34003191","Total",253,120,133,253,0,5,21.00,12.0
"2011","Weaverthorpe BUA","E34003192","Total",349,185,164,349,0,5,22.75,15.3
"2011","Fowey BUA","E34003193","Total",2131,992,1139,2072,59,38,100.75,21.2
"2011","Haughton BUA","E34003194","Total",920,462,458,909,11,18,30.25,30.4
"2011","Mickle Trafford BUA","E34003195","Total",1822,892,930,1822,0,57,56.00,32.5
"2011","Oundle BUA","E34003196","Total",5735,2862,2873,4834,901,167,195.25,29.4
"2011","Everdon BUA","E34003197","Total",356,176,180,356,0,18,21.50,16.6
"2011","Morcott BUA","E34003198","Total",321,155,166,321,0,8,23.50,13.7
"2011","Heath and Reach BUA","E34003199","Total",1346,685,661,1346,0,20,39.50,34.1
"2011","Gamston BUA","E34003200","Total",246,132,114,246,0,3,23.50,10.5
"2011","Bisley BUA","E34003201","Total",936,464,472,936,0,27,35.25,26.6
"2011","Long Wittenham BUA","E34003202","Total",876,430,446,876,0,12,37.00,23.7
"2011","Tilstock BUA","E34003203","Total",809,400,409,770,39,12,23.75,34.1
"2011","Mere BUA","E34003204","Total",2686,1297,1389,2619,67,47,117.00,23.0
"2011","Sherburn in Elmet BUA","E34003205","Total",6657,3295,3362,6629,28,89,376.50,17.7
"2011","Ludlow BUA","E34003206","Total",10515,5062,5453,10374,141,127,319.50,32.9
"2011","Worfield BUA","E34003207","Total",279,144,135,279,0,4,22.50,12.4
"2011","Thanington Without BUA","E34003208","Total",331,153,178,331,0,4,22.00,15.0
"2011","Bradford Abbas BUA","E34003209","Total",975,461,514,975,0,15,35.25,27.7
"2011","Reeth BUA","E34003210","Total",724,342,382,719,5,7,21.50,33.7
"2011","Iwade BUA","E34003211","Total",3087,1539,1548,3087,0,17,56.25,54.9
"2011","Godshill (Isle of Wight) BUA","E34003212","Total",1459,717,742,1459,0,9,38.75,37.7
"2011","Thorpe Salvin BUA","E34003213","Total",476,230,246,458,18,9,26.25,18.1
"2011","Harling Road BUA","E34003214","Total",301,156,145,300,1,1,27.25,11.0
"2011","Bardwell BUA","E34003215","Total",643,323,320,643,0,13,45.25,14.2
"2011","Cotford St Luke BUA","E34003216","Total",2309,1116,1193,2309,0,39,41.75,55.3
"2011","Risegate BUA","E34003217","Total",785,394,391,785,0,5,47.75,16.4
"2011","Bingham BUA","E34003218","Total",9131,4418,4713,9100,31,130,230.00,39.7
"2011","Firsdown BUA","E34003219","Total",581,279,302,581,0,15,39.25,14.8
"2011","Southend BUA","E34003220","Total",738,369,369,735,3,22,48.50,15.2
"2011","Seamer (Scarborough) BUA","E34003221","Total",2006,958,1048,2001,5,33,57.75,34.7
"2011","Lewes BUA","E34003222","Total",17297,8448,8849,16916,381,301,373.50,46.3
"2011","Newtown Linford BUA","E34003223","Total",537,263,274,537,0,18,54.50,9.9
"2011","Kilsby BUA","E34003224","Total",1196,581,615,1157,39,24,42.75,28.0
"2011","Burton Pidsea BUA","E34003225","Total",944,485,459,944,0,4,40.25,23.5
"2011","Pegswood BUA","E34003226","Total",3280,1617,1663,3269,11,28,69.25,47.4
"2011","Kirk Ireton BUA","E34003227","Total",518,258,260,516,2,10,20.25,25.6
"2011","Barrow (St. Edmundsbury) BUA","E34003228","Total",1677,791,886,1677,0,22,61.25,27.4
"2011","Stanford in the Vale BUA","E34003229","Total",2093,1056,1037,2059,34,37,77.50,27.0
"2011","Risby BUA","E34003230","Total",866,416,450,777,89,15,49.00,17.7
"2011","Thurlestone BUA","E34003231","Total",627,302,325,587,40,11,64.75,9.7
"2011","Aldeburgh BUA","E34003232","Total",2341,1060,1281,2299,42,27,160.75,14.6
"2011","Marshchapel BUA","E34003233","Total",704,341,363,704,0,8,34.75,20.3
"2011","Newton Regis BUA","E34003234","Total",599,297,302,599,0,18,20.50,29.2
"2011","Enton Green BUA","E34003235","Total",271,141,130,271,0,25,34.25,7.9
"2011","Langley BUA","E34003236","Total",355,179,176,355,0,7,27.00,13.1
"2011","Bradfield BUA","E34003237","Total",1161,675,486,561,600,32,37.50,31.0
"2011","Mouldsworth BUA","E34003238","Total",327,165,162,327,0,5,32.75,10.0
"2011","Ratby BUA","E34003239","Total",4468,2152,2316,4468,0,45,98.00,45.6
"2011","Aston Abbotts BUA","E34003240","Total",366,176,190,363,3,10,22.00,16.6
"2011","Benson BUA","E34003241","Total",5802,3073,2729,5109,693,103,304.25,19.1
"2011","Gawsworth BUA","E34003242","Total",703,340,363,703,0,14,41.75,16.8
"2011","Liphook BUA","E34003243","Total",6480,3112,3368,6431,49,165,223.25,29.0
"2011","Haxby BUA","E34003244","Total",11894,5555,6339,11739,155,199,280.25,42.4
"2011","Panfield BUA","E34003245","Total",841,424,417,841,0,18,30.25,27.8
"2011","Potterne BUA","E34003246","Total",1622,775,847,1617,5,45,62.75,25.8
"2011","Montacute BUA","E34003247","Total",533,262,271,531,2,8,20.75,25.7
"2011","Filby BUA","E34003248","Total",765,386,379,765,0,7,53.25,14.4
"2011","North Wheatley BUA","E34003249","Total",509,246,263,509,0,19,43.75,11.6
"2011","Orleton BUA","E34003250","Total",573,280,293,573,0,12,35.00,16.4
"2011","Sturton by Stow BUA","E34003251","Total",871,412,459,871,0,13,56.00,15.6
"2011","Drayton St Leonard BUA","E34003252","Total",267,137,130,267,0,9,25.00,10.7
"2011","Shaftesbury BUA","E34003253","Total",7314,3488,3826,7139,175,116,260.75,28.0
"2011","Hickling (Rushcliffe) BUA","E34003254","Total",369,192,177,369,0,8,34.75,10.6
"2011","Litchborough BUA","E34003255","Total",321,167,154,321,0,5,21.00,15.3
"2011","Elkesley BUA","E34003256","Total",822,393,429,822,0,7,219.50,3.7
"2011","Charing BUA","E34003257","Total",1841,867,974,1801,40,29,103.75,17.7
"2011","Bungay BUA","E34003258","Total",5127,2472,2655,4990,137,46,192.75,26.6
"2011","Wadworth BUA","E34003259","Total",1137,546,591,1137,0,16,39.75,28.6
"2011","Totternhoe BUA","E34003260","Total",982,466,516,982,0,7,52.50,18.7
"2011","Swynnerton BUA","E34003261","Total",484,223,261,484,0,11,21.25,22.8
"2011","Whittington (Shropshire) BUA","E34003262","Total",1481,717,764,1471,10,16,56.75,26.1
"2011","Benington BUA","E34003263","Total",608,297,311,608,0,7,35.25,17.2
"2011","Brookville BUA","E34003264","Total",333,158,175,333,0,2,34.50,9.7
"2011","Walkern BUA","E34003265","Total",1541,784,757,1541,0,33,53.00,29.1
"2011","Pathfinder Village BUA","E34003266","Total",497,240,257,497,0,0,36.25,13.7
"2011","Fressingfield BUA","E34003267","Total",790,391,399,790,0,10,37.25,21.2
"2011","Bickershaw BUA","E34003268","Total",826,518,308,614,212,3,25.75,32.1
"2011","Ashbury BUA","E34003269","Total",506,253,253,506,0,10,23.25,21.8
"2011","Frithville BUA","E34003270","Total",288,149,139,288,0,8,22.25,12.9
"2011","Lyonshall BUA","E34003271","Total",521,247,274,430,91,9,22.00,23.7
"2011","Narborough BUA","E34003272","Total",1094,532,562,1094,0,8,47.50,23.0
"2011","Banham BUA","E34003273","Total",1159,595,564,1133,26,23,67.75,17.1
"2011","Skidby BUA","E34003274","Total",1132,537,595,1105,27,26,46.25,24.5
"2011","Cladswell BUA","E34003275","Total",546,270,276,546,0,12,31.75,17.2
"2011","Chilton Foliat BUA","E34003276","Total",363,175,188,363,0,11,21.00,17.3
"2011","Quintrell Downs BUA","E34003277","Total",1001,468,533,1000,1,9,31.75,31.5
"2011","Wendlebury BUA","E34003278","Total",421,205,216,421,0,13,23.00,18.3
"2011","Lenwade BUA","E34003279","Total",496,240,256,496,0,5,21.50,23.1
"2011","Grasby BUA","E34003280","Total",480,230,250,480,0,12,34.50,13.9
"2011","Hilton (Huntingdonshire) BUA","E34003281","Total",1052,519,533,1048,4,32,51.75,20.3
"2011","Derry Hill BUA","E34003282","Total",950,456,494,904,46,25,52.25,18.2
"2011","Hopwood BUA","E34003283","Total",993,493,500,904,89,5,40.50,24.5
"2011","Ripe BUA","E34003284","Total",216,105,111,216,0,7,24.00,9.0
"2011","King's Thorn BUA","E34003285","Total",826,409,417,826,0,28,67.50,12.2
"2011","Newent BUA","E34003286","Total",4322,2075,2247,4308,14,57,162.00,26.7
"2011","Marham BUA","E34003287","Total",733,364,369,729,4,11,33.50,21.9
"2011","Danehill BUA","E34003288","Total",219,109,110,219,0,5,36.00,6.1
"2011","Thursby BUA","E34003289","Total",846,415,431,846,0,5,32.00,26.4
"2011","Well Hill BUA","E34003290","Total",255,121,134,255,0,4,35.00,7.3
"2011","Chetnole BUA","E34003291","Total",344,174,170,344,0,11,37.00,9.3
"2011","Ogbourne St George BUA","E34003292","Total",495,246,249,489,6,11,25.75,19.2
"2011","Temple Herdewyke BUA","E34003293","Total",766,415,351,672,94,1,27.00,28.4
"2011","Calne BUA","E34003294","Total",17274,8327,8947,16893,381,200,401.00,43.1
"2011","St Olaves BUA","E34003295","Total",282,136,146,282,0,5,31.25,9.0
"2011","Ecton BUA","E34003296","Total",466,231,235,460,6,2,20.50,22.7
"2011","King's Hill BUA","E34003297","Total",7459,3730,3729,7459,0,96,214.50,34.8
"2011","Fifield BUA","E34003298","Total",569,277,292,530,39,11,26.00,21.9
"2011","Cobham (Elmbridge) BUA","E34003299","Total",17273,8372,8901,16917,356,643,861.50,20.0
"2011","Aylburton BUA","E34003300","Total",711,351,360,711,0,11,31.00,22.9
"2011","Upton Scudamore BUA","E34003301","Total",295,147,148,295,0,7,20.50,14.4
"2011","Dulverton BUA","E34003302","Total",1052,492,560,1044,8,13,57.50,18.3
"2011","Barkisland BUA","E34003303","Total",1004,484,520,1004,0,16,28.75,34.9
"2011","Latchingdon BUA","E34003304","Total",1182,558,624,1181,1,10,53.00,22.3
"2011","Lund BUA","E34003305","Total",308,152,156,308,0,10,33.50,9.2
"2011","Hinderclay BUA","E34003306","Total",326,153,173,326,0,8,28.50,11.4
"2011","North Kilworth BUA","E34003307","Total",597,301,296,597,0,11,27.25,21.9
"2011","Beccles BUA","E34003308","Total",13868,6653,7215,13740,128,135,411.75,33.7
"2011","Spetisbury BUA","E34003309","Total",555,281,274,535,20,16,35.50,15.6
"2011","Castleton (Scarborough) BUA","E34003310","Total",552,270,282,545,7,19,23.25,23.7
"2011","Draycott in the Clay BUA","E34003311","Total",250,116,134,250,0,2,23.25,10.8
"2011","Great Waltham BUA","E34003312","Total",847,422,425,847,0,17,31.00,27.3
"2011","Hunmanby BUA","E34003313","Total",3132,1496,1636,3130,2,38,125.00,25.1
"2011","Therfield BUA","E34003314","Total",320,169,151,311,9,4,31.25,10.2
"2011","Goldsborough BUA","E34003315","Total",469,232,237,466,3,12,23.75,19.7
"2011","Methwold BUA","E34003316","Total",914,458,456,914,0,9,54.25,16.8
"2011","Nether Compton BUA","E34003317","Total",328,164,164,328,0,4,36.75,8.9
"2011","Chagford BUA","E34003318","Total",1020,482,538,1009,11,17,38.00,26.8
"2011","Asfordby BUA","E34003319","Total",2446,1165,1281,2446,0,23,61.25,39.9
"2011","Legbourne BUA","E34003320","Total",644,318,326,644,0,6,39.75,16.2
"2011","Cawthorne BUA","E34003321","Total",893,428,465,893,0,12,54.00,16.5
"2011","Holme Lacy BUA","E34003322","Total",466,241,225,456,10,8,20.25,23.0
"2011","Whittington Barracks BUA","E34003323","Total",331,179,152,304,27,12,31.25,10.6
"2011","Aston-on-Trent BUA","E34003324","Total",2160,1048,1112,2154,6,31,72.75,29.7
"2011","Bowburn BUA","E34003325","Total",3884,1903,1981,3817,67,32,107.50,36.1
"2011","Beckley (Rother) BUA","E34003326","Total",706,345,361,706,0,10,33.50,21.1
"2011","Mytholmroyd BUA","E34003327","Total",3949,1862,2087,3947,2,41,129.50,30.5
"2011","Soberton BUA","E34003328","Total",326,164,162,326,0,15,22.00,14.8
"2011","Knowbury BUA","E34003329","Total",318,151,167,318,0,7,28.25,11.3
"2011","Higham Park BUA","E34003330","Total",647,311,336,610,37,11,50.50,12.8
"2011","Netherbury BUA","E34003331","Total",343,151,192,343,0,6,28.00,12.2
"2011","Tiptree BUA","E34003332","Total",9182,4440,4742,9157,25,79,290.00,31.7
"2011","Croucheston BUA","E34003333","Total",462,227,235,462,0,8,32.25,14.3
"2011","North Cadbury BUA","E34003334","Total",638,314,324,638,0,20,29.25,21.8
"2011","Newton Poppleford BUA","E34003335","Total",1715,807,908,1715,0,27,75.75,22.6
"2011","Eakring BUA","E34003336","Total",419,205,214,419,0,10,33.00,12.7
"2011","Gamlingay BUA","E34003337","Total",3247,1608,1639,3247,0,45,91.25,35.6
"2011","Stratton-on-the-Fosse BUA","E34003338","Total",995,544,451,626,369,20,31.50,31.6
"2011","Kislingbury BUA","E34003339","Total",1237,614,623,1237,0,16,44.75,27.6
"2011","Fishtoft BUA","E34003340","Total",1085,514,571,1085,0,14,34.25,31.7
"2011","Bottesford BUA","E34003341","Total",3348,1618,1730,3348,0,55,135.75,24.7
"2011","Swanmore BUA","E34003342","Total",2683,1286,1397,2683,0,72,102.00,26.3
"2011","Peacehaven BUA","E34003343","Total",18579,9027,9552,18408,171,94,416.75,44.6
"2011","Old Langho BUA","E34003344","Total",1324,664,660,1314,10,39,42.00,31.5
"2011","Littleton Panell BUA","E34003345","Total",1502,753,749,1151,351,52,80.00,18.8
"2011","Slingsby BUA","E34003346","Total",665,324,341,665,0,17,29.00,22.9
"2011","Tetbury BUA","E34003347","Total",5472,2598,2874,5406,66,71,165.50,33.1
"2011","Kirton (Suffolk Coastal) BUA","E34003348","Total",1146,577,569,1146,0,19,52.25,21.9
"2011","Tydd St Mary BUA","E34003349","Total",718,352,366,718,0,5,40.25,17.8
"2011","Wenhaston BUA","E34003350","Total",475,227,248,475,0,16,42.75,11.1
"2011","Glentham BUA","E34003351","Total",508,241,267,508,0,4,31.50,16.1
"2011","Mollington (Cherwell) BUA","E34003352","Total",479,244,235,479,0,11,23.75,20.2
"2011","Bishopsteignton BUA","E34003353","Total",2209,1028,1181,2143,66,18,99.00,22.3
"2011","Leighton Buzzard BUA","E34003354","Total",37469,18517,18952,37209,260,534,864.00,43.4
"2011","Little Waldingfield BUA","E34003355","Total",366,168,198,342,24,5,23.50,15.6
"2011","Ullesthorpe BUA","E34003356","Total",903,463,440,903,0,11,35.00,25.8
"2011","Uffculme BUA","E34003357","Total",2021,974,1047,2012,9,12,63.00,32.1
"2011","Pembridge BUA","E34003358","Total",489,244,245,489,0,6,28.25,17.3
"2011","Grampound Road BUA","E34003359","Total",926,437,489,926,0,17,24.00,38.6
"2011","Staxton BUA","E34003360","Total",737,371,366,734,3,16,21.50,34.3
"2011","Cranage BUA","E34003361","Total",365,183,182,364,1,15,22.25,16.4
"2011","Ham BUA","E34003362","Total",210,108,102,210,0,19,30.75,6.8
"2011","Broughton in Furness BUA","E34003363","Total",529,255,274,529,0,15,23.75,22.3
"2011","Oaksey BUA","E34003364","Total",530,275,255,524,6,19,27.00,19.6
"2011","Long Compton BUA","E34003365","Total",764,363,401,760,4,9,45.25,16.9
"2011","Boscastle BUA","E34003366","Total",641,312,329,636,5,4,55.00,11.7
"2011","Capel BUA","E34003367","Total",1239,614,625,1239,0,11,49.25,25.2
"2011","Chirton BUA","E34003368","Total",406,192,214,406,0,7,24.50,16.6
"2011","Greenfield BUA","E34003369","Total",1831,932,899,1831,0,42,74.50,24.6
"2011","Mickleton (County Durham) BUA","E34003370","Total",413,196,217,413,0,7,24.00,17.2
"2011","Pattishall BUA","E34003371","Total",664,337,327,664,0,18,38.25,17.4
"2011","Notton BUA","E34003372","Total",479,238,241,479,0,8,28.50,16.8
"2011","Thurlton BUA","E34003373","Total",1077,534,543,1074,3,15,40.50,26.6
"2011","Slimbridge BUA","E34003374","Total",742,372,370,727,15,14,30.25,24.5
"2011","Newport (Uttlesford) BUA","E34003375","Total",2352,1164,1188,2352,0,58,87.50,26.9
"2011","Broughton Astley BUA","E34003376","Total",8940,4477,4463,8907,33,131,200.50,44.6
"2011","Pontesbury BUA","E34003377","Total",1873,908,965,1852,21,25,80.75,23.2
"2011","Selborne BUA","E34003378","Total",540,249,291,540,0,21,42.50,12.7
"2011","Casterton BUA","E34003379","Total",425,127,298,274,151,17,21.50,19.8
"2011","Lostwithiel BUA","E34003380","Total",2659,1252,1407,2538,121,23,82.50,32.2
"2011","Waltham St Lawrence BUA","E34003381","Total",504,240,264,504,0,14,60.25,8.4
"2011","Perham Down BUA","E34003382","Total",1447,967,480,943,504,26,48.50,29.8
"2011","Cattistock BUA","E34003383","Total",509,243,266,509,0,11,21.75,23.4
"2011","Ridgewell BUA","E34003384","Total",509,247,262,509,0,8,26.25,19.4
"2011","Charmouth BUA","E34003385","Total",1352,641,711,1317,35,21,69.00,19.6
"2011","Preston Candover BUA","E34003386","Total",510,258,252,510,0,20,32.75,15.6
"2011","Buckland BUA","E34003387","Total",588,285,303,582,6,22,24.25,24.2
"2011","Navenby BUA","E34003388","Total",2932,1381,1551,2885,47,41,106.75,27.5
"2011","Whittlesey BUA","E34003389","Total",12745,6136,6609,12645,100,135,356.50,35.8
"2011","Edingley BUA","E34003390","Total",443,210,233,395,48,11,22.75,19.5
"2011","North Marston BUA","E34003391","Total",781,378,403,781,0,33,31.25,25.0
"2011","Gaunt's Common BUA","E34003392","Total",473,228,245,473,0,8,45.00,10.5
"2011","Brushford BUA","E34003393","Total",221,102,119,219,2,1,21.25,10.4
"2011","Holmeswood (West) BUA","E34003394","Total",369,197,172,369,0,6,22.75,16.2
"2011","Grantchester BUA","E34003395","Total",540,249,291,540,0,14,35.25,15.3
"2011","Middle Winterslow BUA","E34003396","Total",1579,763,816,1579,0,47,73.50,21.5
"2011","Brandon (Forest Heath) BUA","E34003397","Total",9145,4575,4570,9085,60,52,327.00,28.0
"2011","Langford (West Oxfordshire) BUA","E34003398","Total",349,177,172,349,0,16,25.00,14.0
"2011","Thundridge BUA","E34003399","Total",704,347,357,696,8,12,34.75,20.3
"2011","Springhill BUA","E34003400","Total",509,257,252,482,27,5,30.00,17.0
"2011","Upper Boddington BUA","E34003401","Total",451,235,216,451,0,15,32.00,14.1
"2011","Nettlebed BUA","E34003402","Total",727,347,380,723,4,16,20.75,35.0
"2011","Wolston BUA","E34003403","Total",2564,1254,1310,2524,40,42,63.50,40.4
"2011","Challock BUA","E34003404","Total",920,454,466,920,0,19,52.75,17.4
"2011","Kilkhampton BUA","E34003405","Total",853,420,433,853,0,5,54.00,15.8
"2011","School Aycliffe BUA","E34003406","Total",669,332,337,669,0,18,27.00,24.8
"2011","Fordcombe BUA","E34003407","Total",559,271,288,559,0,18,25.25,22.1
"2011","Oswaldkirk BUA","E34003408","Total",230,105,125,230,0,6,22.25,10.3
"2011","Surfleet Seas End BUA","E34003409","Total",988,500,488,988,0,12,81.00,12.2
"2011","Brant Broughton BUA","E34003410","Total",744,362,382,717,27,18,36.00,20.7
"2011","Barton (Wyre) BUA","E34003411","Total",1154,555,599,1154,0,29,60.25,19.2
"2011","Cottenham BUA","E34003412","Total",5903,2858,3045,5817,86,111,186.25,31.7
"2011","Little Houghton BUA","E34003413","Total",403,191,212,403,0,12,23.75,17.0
"2011","Stoke Golding BUA","E34003414","Total",1684,843,841,1684,0,30,62.25,27.1
"2011","Boughton BUA","E34003415","Total",227,119,108,227,0,7,27.50,8.3
"2011","Stoke St Michael BUA","E34003416","Total",731,358,373,726,5,7,31.50,23.2
"2011","Lamerton BUA","E34003417","Total",859,394,465,794,65,16,23.75,36.2
"2011","Bourne BUA","E34003418","Total",13961,6669,7292,13755,206,258,409.50,34.1
"2011","Bratton Fleming BUA","E34003419","Total",928,447,481,884,44,21,31.25,29.7
"2011","Cobham (Gravesham) BUA","E34003420","Total",269,128,141,269,0,4,22.00,12.2
"2011","Barnetby le Wold BUA","E34003421","Total",1741,840,901,1726,15,22,70.00,24.9
"2011","Parson Drove BUA","E34003422","Total",828,388,440,828,0,14,58.75,14.1
"2011","St Just BUA","E34003423","Total",1957,949,1008,1913,44,23,45.75,42.8
"2011","Staplehurst BUA","E34003424","Total",5051,2449,2602,4949,102,76,131.75,38.3
"2011","Cheadle BUA","E34003425","Total",11404,5645,5759,11199,205,121,362.00,31.5
"2011","Fishlake BUA","E34003426","Total",370,192,178,370,0,5,43.25,8.6
"2011","Wingrave BUA","E34003427","Total",1389,683,706,1352,37,24,55.75,24.9
"2011","Wye BUA","E34003428","Total",1915,911,1004,1888,27,31,65.00,29.5
"2011","Heversham BUA","E34003429","Total",699,335,364,689,10,18,46.50,15.0
"2011","Spofforth BUA","E34003430","Total",1169,553,616,1169,0,22,44.25,26.4
"2011","Pinesfield Lane, nr Culverstone Green BUA","E34003431","Total",228,108,120,228,0,4,23.25,9.8
"2011","Knowle Hill BUA","E34003432","Total",809,674,135,252,557,2,23.75,34.1
"2011","Maltby le Marsh BUA","E34003433","Total",342,174,168,340,2,5,39.75,8.6
"2011","Brompton-by-Sawdon BUA","E34003434","Total",304,150,154,304,0,11,26.50,11.5
"2011","University of Nottingham School of Agriculture BUA","E34003435","Total",713,249,464,135,578,16,28.50,25.0
"2011","Ashcott BUA","E34003436","Total",876,441,435,869,7,24,45.00,19.5
"2011","Rollesby BUA","E34003437","Total",651,332,319,651,0,12,25.00,26.0
"2011","Hindon BUA","E34003438","Total",560,260,300,559,1,26,32.00,17.5
"2011","Hulland Ward BUA","E34003439","Total",718,327,391,718,0,8,33.75,21.3
"2011","Brixworth BUA","E34003440","Total",5228,2558,2670,5150,78,121,148.00,35.3
"2011","Ickleton BUA","E34003441","Total",709,361,348,709,0,17,35.00,20.3
"2011","Bar Hill BUA","E34003442","Total",4032,2031,2001,4026,6,63,109.50,36.8
"2011","Dartington BUA","E34003443","Total",876,391,485,844,32,14,43.25,20.3
"2011","Ash Green BUA","E34003444","Total",477,239,238,471,6,13,32.75,14.6
"2011","Friston BUA","E34003445","Total",1620,761,859,1601,19,23,126.25,12.8
"2011","Upper Tysoe BUA","E34003446","Total",914,455,459,914,0,21,46.75,19.6
"2011","Stoke Gabriel BUA","E34003447","Total",1107,535,572,1107,0,22,57.50,19.3
"2011","Wherwell BUA","E34003448","Total",473,225,248,473,0,18,25.25,18.7
"2011","Fosdyke BUA","E34003449","Total",480,232,248,480,0,3,25.75,18.6
"2011","Downton BUA","E34003450","Total",2731,1336,1395,2731,0,41,121.50,22.5
"2011","North Stoke BUA","E34003451","Total",362,187,175,348,14,4,21.00,17.2
"2011","Wymondham (Melton) BUA","E34003452","Total",632,328,304,632,0,14,30.75,20.6
"2011","Barnes Street BUA","E34003453","Total",565,278,287,565,0,12,23.50,24.0
"2011","Humshaugh BUA","E34003454","Total",622,303,319,617,5,18,24.75,25.1
"2011","Lyndhurst BUA","E34003455","Total",2347,1135,1212,2247,100,29,112.75,20.8
"2011","Chipping Ongar BUA","E34003456","Total",6093,2936,3157,6093,0,84,156.00,39.1
"2011","Kirton (Boston) BUA","E34003457","Total",4821,2279,2542,4771,50,47,160.75,30.0
"2011","Dumbleton BUA","E34003458","Total",576,271,305,569,7,19,21.75,26.5
"2011","Ufford (City of Peterborough) BUA","E34003459","Total",225,111,114,225,0,6,22.75,9.9
"2011","Westleigh BUA","E34003460","Total",593,302,291,582,11,5,34.00,17.4
"2011","Great Horwood BUA","E34003461","Total",1049,546,503,1049,0,31,40.25,26.1
"2011","Fleetwood BUA","E34003462","Total",25359,12341,13018,25064,295,185,514.50,49.3
"2011","Shildon BUA","E34003463","Total",9976,4856,5120,9852,124,66,262.75,38.0
"2011","St Cleer BUA","E34003464","Total",1744,853,891,1744,0,20,38.25,45.6
"2011","Barton Stacey BUA","E34003465","Total",780,398,382,780,0,24,40.25,19.4
"2011","Brocton BUA","E34003466","Total",759,378,381,759,0,33,48.00,15.8
"2011","Haddenham (East Cambridgeshire) BUA","E34003467","Total",2937,1478,1459,2937,0,27,148.75,19.7
"2011","Chideock BUA","E34003468","Total",686,331,355,686,0,8,35.00,19.6
"2011","Aynho BUA","E34003469","Total",651,325,326,649,2,23,33.25,19.6
"2011","Lakenheath Airfield BUA","E34003470","Total",2892,1667,1225,1848,1044,13,604.25,4.8
"2011","Ashford Carbonell BUA","E34003471","Total",321,155,166,321,0,20,29.50,10.9
"2011","Carlton (Stockton-on-Tees) BUA","E34003472","Total",726,366,360,714,12,19,25.25,28.8
"2011","Langford Budville BUA","E34003473","Total",535,279,256,535,0,18,20.50,26.1
"2011","Kenton BUA","E34003474","Total",1005,494,511,998,7,13,47.00,21.4
"2011","Ottringham BUA","E34003475","Total",597,294,303,597,0,7,21.75,27.4
"2011","Sharnford BUA","E34003476","Total",985,488,497,985,0,14,46.50,21.2
"2011","Horton (South Gloucestershire) BUA","E34003477","Total",355,171,184,355,0,12,23.25,15.3
"2011","Oakington BUA","E34003478","Total",1527,765,762,1526,1,32,68.50,22.3
"2011","Haltwhistle BUA","E34003479","Total",3791,1858,1933,3782,9,46,119.50,31.7
"2011","Ide Hill BUA","E34003480","Total",389,192,197,389,0,7,28.75,13.5
"2011","Milton Ernest BUA","E34003481","Total",761,363,398,746,15,25,29.50,25.8
"2011","Datchet BUA","E34003482","Total",4913,2427,2486,4880,33,97,136.50,36.0
"2011","Foston (South Kesteven) BUA","E34003483","Total",525,263,262,525,0,10,31.75,16.5
"2011","Barley BUA","E34003484","Total",662,316,346,645,17,22,47.25,14.0
"2011","Curtisden Green BUA","E34003485","Total",558,354,204,342,216,16,21.00,26.6
"2011","Hampsthwaite BUA","E34003486","Total",923,430,493,923,0,20,40.25,22.9
"2011","Mistley BUA","E34003487","Total",1696,831,865,1696,0,15,48.50,35.0
"2011","Laxton BUA","E34003488","Total",449,223,226,448,1,16,24.25,18.5
"2011","Broad Heath BUA","E34003489","Total",278,144,134,278,0,7,22.25,12.5
"2011","Hemsby BUA","E34003490","Total",5522,2657,2865,5393,129,68,367.75,15.0
"2011","Ashby-de-la-Zouch BUA","E34003491","Total",12370,6071,6299,12177,193,210,395.00,31.3
"2011","King's Bromley BUA","E34003492","Total",999,481,518,947,52,17,51.50,19.4
"2011","Coalhill BUA","E34003493","Total",308,166,142,308,0,3,25.25,12.2
"2011","Wadebridge BUA","E34003494","Total",6599,3020,3579,6407,192,92,195.00,33.8
"2011","Pailton BUA","E34003495","Total",516,277,239,516,0,7,27.25,18.9
"2011","Camber BUA","E34003496","Total",1265,618,647,1258,7,12,69.75,18.1
"2011","Heytesbury BUA","E34003497","Total",540,250,290,540,0,21,25.75,21.0
"2011","Wicken Bonhunt BUA","E34003498","Total",223,111,112,223,0,6,26.50,8.4
"2011","Dauntsey BUA","E34003499","Total",590,298,292,590,0,17,24.75,23.8
"2011","Stoke (Havant) BUA","E34003500","Total",1271,628,643,1258,13,17,59.25,21.5
"2011","Helmsley BUA","E34003501","Total",1515,726,789,1504,11,17,66.00,23.0
"2011","Marston Magna BUA","E34003502","Total",523,266,257,503,20,8,37.50,13.9
"2011","Chiddingfold BUA","E34003503","Total",2211,1110,1101,2165,46,79,111.75,19.8
"2011","Beanacre BUA","E34003504","Total",314,161,153,312,2,13,25.25,12.4
"2011","Tarvin BUA","E34003505","Total",2309,1099,1210,2309,0,38,72.75,31.7
"2011","Neasham BUA","E34003506","Total",376,184,192,376,0,3,25.25,14.9
"2011","Staindrop BUA","E34003507","Total",1310,626,684,1310,0,22,48.75,26.9
"2011","Takeley Street BUA","E34003508","Total",369,181,188,366,3,7,20.75,17.8
"2011","Marsham BUA","E34003509","Total",521,256,265,515,6,7,30.25,17.2
"2011","Broadclyst BUA","E34003510","Total",1467,711,756,1429,38,29,51.75,28.3
"2011","Harpenden BUA","E34003511","Total",30240,14773,15467,29707,533,952,889.50,34.0
"2011","Melsonby BUA","E34003512","Total",735,349,386,735,0,14,24.00,30.6
"2011","Upton upon Severn BUA","E34003513","Total",1861,884,977,1854,7,18,56.00,33.2
"2011","Halesworth BUA","E34003514","Total",5558,2626,2932,5484,74,60,259.00,21.5
"2011","Staithes BUA","E34003515","Total",826,399,427,823,3,4,34.50,23.9
"2011","Masham BUA","E34003516","Total",1205,558,647,1201,4,14,48.00,25.1
"2011","Attleborough BUA","E34003517","Total",10549,5168,5381,10409,140,108,302.25,34.9
"2011","Bumble's Green BUA","E34003518","Total",504,255,249,504,0,6,25.50,19.8
"2011","Wortwell BUA","E34003519","Total",561,282,279,561,0,6,28.00,20.0
"2011","Heighington BUA","E34003520","Total",1383,682,701,1383,0,21,45.00,30.7
"2011","Sea Palling BUA","E34003521","Total",451,228,223,447,4,2,31.00,14.5
"2011","Great Bircham BUA","E34003522","Total",448,226,222,448,0,9,25.25,17.7
"2011","Pointon BUA","E34003523","Total",532,258,274,532,0,12,25.50,20.9
"2011","Coddenham BUA","E34003524","Total",620,309,311,620,0,11,26.25,23.6
"2011","Fleet BUA","E34003525","Total",38726,19100,19626,38411,315,770,1198.75,32.3
"2011","Flecknoe BUA","E34003526","Total",284,139,145,284,0,15,22.00,12.9
"2011","Holcombe Rogus BUA","E34003527","Total",261,126,135,261,0,4,28.50,9.2
"2011","Caistor BUA","E34003528","Total",2489,1211,1278,2455,34,42,110.75,22.5
"2011","Whittlebury BUA","E34003529","Total",589,315,274,587,2,25,32.00,18.4
"2011","Hartpury College BUA","E34003530","Total",943,453,490,90,853,51,22.50,41.9
"2011","Brigstock BUA","E34003531","Total",1357,672,685,1357,0,32,54.00,25.1
"2011","Great Rollright BUA","E34003532","Total",502,246,256,502,0,16,21.25,23.6
"2011","North Newton BUA","E34003533","Total",355,176,179,355,0,10,32.75,10.8
"2011","Needham BUA","E34003534","Total",309,153,156,309,0,4,29.25,10.6
"2011","Upper Arncott BUA","E34003535","Total",770,383,387,759,11,1,63.75,12.1
"2011","Milborne Port BUA","E34003536","Total",2802,1372,1430,2802,0,48,101.00,27.7
"2011","Fairlight BUA","E34003537","Total",1516,725,791,1499,17,15,111.50,13.6
"2011","Ascott-under-Wychwood BUA","E34003538","Total",560,261,299,560,0,17,28.50,19.6
"2011","Appleby Magna BUA","E34003539","Total",962,488,474,960,2,24,43.00,22.4
"2011","New Holland BUA","E34003540","Total",970,501,469,970,0,10,61.75,15.7
"2011","Ramsey (Huntingdonshire) BUA","E34003541","Total",7829,3874,3955,7751,78,99,294.75,26.6
"2011","Alkborough BUA","E34003542","Total",458,222,236,440,18,6,25.50,18.0
"2011","Goxhill BUA","E34003543","Total",2290,1150,1140,2290,0,31,112.00,20.4
"2011","Bentworth BUA","E34003544","Total",553,270,283,553,0,19,32.00,17.3
"2011","Elton BUA","E34003545","Total",679,318,361,679,0,10,36.00,18.9
"2011","Plumpton Green BUA","E34003546","Total",1123,546,577,1123,0,38,36.25,31.0
"2011","Eyke BUA","E34003547","Total",362,181,181,362,0,6,25.25,14.3
"2011","Cossington BUA","E34003548","Total",564,269,295,564,0,14,33.50,16.8
"2011","Langford (Central Bedfordshire) BUA","E34003549","Total",3091,1543,1548,3083,8,38,103.25,29.9
"2011","Shamley Green BUA","E34003550","Total",1146,539,607,1146,0,34,70.75,16.2
"2011","Burn BUA","E34003551","Total",491,232,259,491,0,1,25.00,19.6
"2011","Acton BUA","E34003552","Total",1639,813,826,1639,0,21,58.00,28.3
"2011","Wantage BUA","E34003553","Total",18505,9122,9383,18284,221,276,443.00,41.8
"2011","Walpole Cross Keys BUA","E34003554","Total",518,268,250,518,0,6,28.50,18.2
"2011","Harmby BUA","E34003555","Total",371,185,186,371,0,8,21.00,17.7
"2011","High Bentham BUA","E34003556","Total",1680,837,843,1668,12,33,68.25,24.6
"2011","Combe BUA","E34003557","Total",768,393,375,768,0,18,30.75,25.0
"2011","Kingham BUA","E34003558","Total",547,292,255,382,165,22,33.75,16.2
"2011","Milton Lilbourne BUA","E34003559","Total",284,136,148,284,0,11,39.50,7.2
"2011","Hawsker BUA","E34003560","Total",291,139,152,290,1,9,22.25,13.1
"2011","East Leake BUA","E34003561","Total",6337,3052,3285,6312,25,95,207.75,30.5
"2011","Askern BUA","E34003562","Total",5570,2744,2826,5522,48,23,121.75,45.7
"2011","Datchworth BUA","E34003563","Total",1210,598,612,1210,0,22,50.00,24.2
"2011","Burwash Common BUA","E34003564","Total",782,384,398,725,57,17,67.00,11.7
"2011","Long Sutton (South Holland) BUA","E34003565","Total",5161,2437,2724,5056,105,33,262.75,19.6
"2011","Battle BUA","E34003566","Total",6054,2855,3199,5951,103,137,276.75,21.9
"2011","Shiplake BUA","E34003567","Total",682,448,234,419,263,35,22.75,30.0
"2011","Shepherdswell BUA","E34003568","Total",1630,780,850,1584,46,15,73.00,22.3
"2011","Stewartby BUA","E34003569","Total",1190,588,602,1189,1,7,96.25,12.4
"2011","Breage BUA","E34003570","Total",471,229,242,471,0,5,21.50,21.9
"2011","Hartley Wintney BUA","E34003571","Total",4488,2152,2336,4488,0,108,179.25,25.0
"2011","Woolpack Corner BUA","E34003572","Total",192,87,105,192,0,0,30.75,6.2
"2011","Pavenham BUA","E34003573","Total",527,266,261,527,0,23,36.25,14.5
"2011","New Ollerton BUA","E34003574","Total",9840,4827,5013,9724,116,81,296.25,33.2
"2011","Burton-by-Lincoln BUA","E34003575","Total",243,115,128,243,0,6,22.50,10.8
"2011","Berry's Green BUA","E34003576","Total",232,116,116,232,0,0,67.00,3.5
"2011","Brinklow BUA","E34003577","Total",1101,564,537,1101,0,12,43.50,25.3
"2011","Charlton Horethorne BUA","E34003578","Total",591,290,301,588,3,22,35.75,16.5
"2011","Carlby BUA","E34003579","Total",542,259,283,542,0,23,23.25,23.3
"2011","Duke's Hill BUA","E34003580","Total",162,91,71,162,0,5,21.25,7.6
"2011","Waterford BUA","E34003581","Total",273,141,132,273,0,7,21.50,12.7
"2011","Clanfield BUA","E34003582","Total",879,436,443,876,3,19,46.25,19.0
"2011","Hurst Green (Rother) BUA","E34003583","Total",1187,606,581,1187,0,21,60.50,19.6
"2011","North Cave BUA","E34003584","Total",1348,670,678,1348,0,29,73.50,18.3
"2011","Evenwood BUA","E34003585","Total",1608,787,821,1560,48,9,53.50,30.1
"2011","Skelton (Eden) BUA","E34003586","Total",370,172,198,370,0,11,22.25,16.6
"2011","Aldwincle BUA","E34003587","Total",322,159,163,322,0,21,36.00,8.9
"2011","Elmsett BUA","E34003588","Total",635,299,336,633,2,11,45.50,14.0
"2011","Little Berkhamsted BUA","E34003589","Total",554,259,295,554,0,26,46.25,12.0
"2011","Belchamp St Paul BUA","E34003590","Total",362,173,189,362,0,9,21.50,16.8
"2011","Reach BUA","E34003591","Total",358,177,181,358,0,4,20.50,17.5
"2011","Westhampnett BUA","E34003592","Total",361,162,199,321,40,8,29.25,12.3
"2011","Whaplode BUA","E34003593","Total",1666,830,836,1666,0,13,82.00,20.3
"2011","Barnston (Uttlesford) BUA","E34003594","Total",947,501,446,947,0,20,21.75,43.5
"2011","Yardley Hastings BUA","E34003595","Total",745,360,385,741,4,20,41.75,17.8
"2011","Uttoxeter BUA","E34003596","Total",13089,6461,6628,12899,190,174,361.25,36.2
"2011","Bircotes BUA","E34003597","Total",7948,3883,4065,7880,68,43,286.25,27.8
"2011","Scropton BUA","E34003598","Total",354,182,172,354,0,3,25.75,13.7
"2011","Collingbourne Kingston BUA","E34003599","Total",511,259,252,511,0,10,24.25,21.1
"2011","Kirkby Thore BUA","E34003600","Total",758,376,382,758,0,7,32.25,23.5
"2011","Ilmington BUA","E34003601","Total",712,356,356,707,5,10,47.50,15.0
"2011","Hauxton BUA","E34003602","Total",673,329,344,673,0,16,28.25,23.8
"2011","Laceby BUA","E34003603","Total",3259,1622,1637,3233,26,43,94.25,34.6
"2011","Littleton BUA","E34003604","Total",647,295,352,588,59,12,38.50,16.8
"2011","Elston BUA","E34003605","Total",631,321,310,622,9,17,39.00,16.2
"2011","North Walsham BUA","E34003606","Total",12463,5931,6532,12209,254,97,439.50,28.4
"2011","Hayton (Allerdale) BUA","E34003607","Total",237,115,122,235,2,4,21.00,11.3
"2011","Kirklington BUA","E34003608","Total",400,200,200,369,31,16,24.25,16.5
"2011","Kenninghall BUA","E34003609","Total",714,347,367,714,0,3,39.25,18.2
"2011","Penwithick BUA","E34003610","Total",1832,918,914,1825,7,9,47.50,38.6
"2011","Nocton BUA","E34003611","Total",819,399,420,787,32,20,46.25,17.7
"2011","Nanstallon BUA","E34003612","Total",616,310,306,614,2,3,21.75,28.3
"2011","Cherington BUA","E34003613","Total",373,173,200,373,0,13,38.25,9.8
"2011","Steeple Ashton BUA","E34003614","Total",935,429,506,935,0,10,46.25,20.2
"2011","Stanton St John BUA","E34003615","Total",430,215,215,430,0,14,25.25,17.0
"2011","Meysey Hampton BUA","E34003616","Total",438,204,234,438,0,22,26.50,16.5
"2011","Greetham BUA","E34003617","Total",638,303,335,615,23,10,36.25,17.6
"2011","Snitterfield BUA","E34003618","Total",989,477,512,989,0,21,53.25,18.6
"2011","Stilton BUA","E34003619","Total",2455,1211,1244,2455,0,32,75.25,32.6
"2011","Fox Street BUA","E34003620","Total",388,203,185,380,8,9,23.00,16.9
"2011","Rackheath/Salhouse BUA","E34003621","Total",336,169,167,331,5,1,30.75,10.9
"2011","High Roding BUA","E34003622","Total",478,237,241,478,0,9,22.75,21.0
"2011","Stow BUA","E34003623","Total",365,183,182,363,2,11,22.00,16.6
"2011","Broad Oak (Wealden) BUA","E34003624","Total",1146,574,572,1146,0,13,42.50,27.0
"2011","Kempsey BUA","E34003625","Total",2609,1240,1369,2573,36,50,91.50,28.5
"2011","Bourton BUA","E34003626","Total",1480,732,748,1480,0,35,111.75,13.2
"2011","Sutton (West Oxfordshire) BUA","E34003627","Total",342,170,172,342,0,13,30.50,11.2
"2011","Seaton (East Devon) BUA","E34003628","Total",8413,3911,4502,8218,195,88,305.50,27.5
"2011","Northborough BUA","E34003629","Total",1318,633,685,1318,0,17,67.75,19.5
"2011","Coopersale BUA","E34003630","Total",1006,494,512,1006,0,14,20.75,48.5
"2011","Scawby BUA","E34003631","Total",1631,792,839,1599,32,33,89.00,18.3
"2011","Sutton Waldron BUA","E34003632","Total",200,93,107,200,0,6,20.50,9.8
"2011","Great Rissington BUA","E34003633","Total",367,182,185,364,3,16,32.75,11.2
"2011","Kibblesworth BUA","E34003634","Total",1174,561,613,1170,4,7,30.00,39.1
"2011","Fulmer BUA","E34003635","Total",230,107,123,230,0,3,25.50,9.0
"2011","Canewdon BUA","E34003636","Total",1072,518,554,1072,0,8,29.75,36.0
"2011","Sporle BUA","E34003637","Total",755,381,374,755,0,7,31.50,24.0
"2011","Portinscale BUA","E34003638","Total",560,279,281,528,32,5,37.50,14.9
"2011","Somerton (South Somerset) BUA","E34003639","Total",4339,2040,2299,4291,48,67,147.25,29.5
"2011","Chudleigh Knighton BUA","E34003640","Total",1125,556,569,1125,0,8,25.50,44.1
"2011","Coltishall BUA","E34003641","Total",2310,1094,1216,2266,44,28,117.75,19.6
"2011","Alderholt BUA","E34003642","Total",2848,1404,1444,2841,7,51,95.25,29.9
"2011","Woolley BUA","E34003643","Total",365,182,183,365,0,8,21.75,16.8
"2011","Toddington BUA","E34003644","Total",4585,2285,2300,4585,0,84,110.75,41.4
"2011","Cumwhinton BUA","E34003645","Total",364,182,182,364,0,7,25.75,14.1
"2011","Shepreth BUA","E34003646","Total",594,302,292,594,0,21,49.00,12.1
"2011","Lye's Green BUA","E34003647","Total",338,167,171,338,0,17,25.00,13.5
"2011","Pilning BUA","E34003648","Total",1465,728,737,1465,0,21,42.25,34.7
"2011","Kingsbury Episcopi BUA","E34003649","Total",641,312,329,641,0,22,30.00,21.4
"2011","Corse Lawn BUA","E34003650","Total",308,155,153,295,13,8,21.00,14.7
"2011","Shortstown BUA","E34003651","Total",2401,1161,1240,2401,0,15,42.00,57.2
"2011","Purleigh BUA","E34003652","Total",526,267,259,526,0,9,28.25,18.6
"2011","Weston Hills BUA","E34003653","Total",803,396,407,803,0,9,29.00,27.7
"2011","Stourpaine BUA","E34003654","Total",617,309,308,617,0,13,30.25,20.4
"2011","Thrussington BUA","E34003655","Total",581,293,288,581,0,11,32.75,17.7
"2011","Pattingham BUA","E34003656","Total",1749,870,879,1749,0,23,55.00,31.8
"2011","Stotfold BUA","E34003657","Total",6838,3350,3488,6838,0,69,167.75,40.8
"2011","Puddletown BUA","E34003658","Total",1158,562,596,1158,0,11,46.25,25.0
"2011","Tisbury BUA","E34003659","Total",2178,1039,1139,2158,20,32,89.25,24.4
"2011","Luddington BUA","E34003660","Total",419,215,204,419,0,5,21.00,20.0
"2011","Chapel Row BUA","E34003661","Total",637,324,313,629,8,35,41.25,15.4
"2011","Chale Green BUA","E34003662","Total",333,162,171,333,0,3,31.75,10.5
"2011","Backworth BUA","E34003663","Total",1399,646,753,1399,0,8,33.00,42.4
"2011","Bradford Peverell BUA","E34003664","Total",370,179,191,369,1,9,20.50,18.0
"2011","Pool BUA","E34003665","Total",1935,961,974,1935,0,38,61.50,31.5
"2011","Westbury-sub-Mendip BUA","E34003666","Total",801,406,395,801,0,33,47.25,17.0
"2011","Othery BUA","E34003667","Total",642,311,331,642,0,10,34.75,18.5
"2011","Spellbrook BUA","E34003668","Total",294,146,148,291,3,9,21.25,13.8
"2011","Blundeston BUA","E34003669","Total",889,438,451,889,0,20,46.25,19.2
"2011","Lambley BUA","E34003670","Total",857,430,427,857,0,9,39.75,21.6
"2011","Barmby Moor BUA","E34003671","Total",903,449,454,903,0,22,35.50,25.4
"2011","Alderton (Tewkesbury) BUA","E34003672","Total",747,368,379,747,0,19,25.00,29.9
"2011","Yoxford BUA","E34003673","Total",726,355,371,726,0,16,41.00,17.7
"2011","Horsmonden BUA","E34003674","Total",1620,775,845,1620,0,31,48.75,33.2
"2011","Blunham BUA","E34003675","Total",946,470,476,946,0,23,63.75,14.8
"2011","Holme next the Sea BUA","E34003676","Total",239,124,115,239,0,6,39.75,6.0
"2011","Willington (South Derbyshire) BUA","E34003677","Total",2862,1448,1414,2862,0,42,85.00,33.7
"2011","Shepshed BUA","E34003678","Total",13505,6623,6882,13221,284,168,339.00,39.8
"2011","Clacton-on-Sea BUA","E34003679","Total",50548,23841,26707,49525,1023,345,1217.00,41.5
"2011","Shadwell BUA","E34003680","Total",1352,660,692,1352,0,33,52.00,26.0
"2011","Swayfield BUA","E34003681","Total",316,154,162,316,0,15,25.00,12.6
"2011","Parwich BUA","E34003682","Total",472,232,240,472,0,9,26.50,17.8
"2011","Gressenhall BUA","E34003683","Total",930,445,485,906,24,10,54.50,17.1
"2011","Chilton (County Durham) BUA","E34003684","Total",3744,1814,1930,3709,35,29,118.00,31.7
"2011","Middleton (King's Lynn and West Norfolk) BUA","E34003685","Total",1191,584,607,1191,0,14,61.75,19.3
"2011","South Cerney BUA","E34003686","Total",2632,1268,1364,2630,2,49,104.50,25.2
"2011","Whitby BUA","E34003687","Total",13213,6419,6794,12875,338,150,377.00,35.0
"2011","Barton-le-Clay BUA","E34003688","Total",4992,2451,2541,4980,12,108,131.25,38.0
"2011","Tebay BUA","E34003689","Total",393,202,191,390,3,3,31.75,12.4
"2011","East Peckham BUA","E34003690","Total",2485,1235,1250,2465,20,32,87.00,28.6
"2011","Barkston BUA","E34003691","Total",493,234,259,493,0,12,31.00,15.9
"2011","Whissonsett BUA","E34003692","Total",488,247,241,488,0,1,26.25,18.6
"2011","Drakes Broughton BUA","E34003693","Total",1392,669,723,1392,0,13,39.00,35.7
"2011","Lawshall BUA","E34003694","Total",669,320,349,644,25,11,24.50,27.3
"2011","Long Riston BUA","E34003695","Total",979,479,500,979,0,10,41.75,23.4
"2011","Ditcheat BUA","E34003696","Total",370,168,202,370,0,12,34.75,10.6
"2011","Frant BUA","E34003697","Total",781,372,409,781,0,27,63.50,12.3
"2011","Great Milton BUA","E34003698","Total",618,297,321,618,0,19,37.75,16.4
"2011","Broadhempston BUA","E34003699","Total",672,323,349,659,13,11,32.00,21.0
"2011","Sancton BUA","E34003700","Total",286,151,135,286,0,3,25.25,11.3
"2011","Framfield BUA","E34003701","Total",665,324,341,665,0,8,43.00,15.5
"2011","Ellerker BUA","E34003702","Total",307,152,155,291,16,9,24.75,12.4
"2011","Buckland Monachorum BUA","E34003703","Total",779,373,406,779,0,19,22.75,34.2
"2011","Woore BUA","E34003704","Total",633,311,322,633,0,14,36.25,17.5
"2011","Gerrans BUA","E34003705","Total",535,239,296,535,0,6,35.00,15.3
"2011","Trebetherick BUA","E34003706","Total",499,229,270,451,48,10,122.50,4.1
"2011","Ashbourne BUA","E34003707","Total",8377,4075,4302,8277,100,145,339.75,24.7
"2011","Galgate BUA","E34003708","Total",2458,1170,1288,1704,754,32,41.00,60.0
"2011","North Curry BUA","E34003709","Total",926,433,493,918,8,20,57.75,16.0
"2011","Cheltenham BUA","E34003710","Total",116447,56892,59555,112874,3573,1697,2886.75,40.3
"2011","Little Somerford BUA","E34003711","Total",357,164,193,346,11,9,21.75,16.4
"2011","Shipbourne BUA","E34003712","Total",470,227,243,470,0,16,21.75,21.6
"2011","Lizard BUA","E34003713","Total",906,457,449,906,0,8,46.00,19.7
"2011","Belton (North West Leicestershire) BUA","E34003714","Total",734,359,375,734,0,16,26.50,27.7
"2011","Hallaton BUA","E34003715","Total",594,290,304,562,32,19,26.50,22.4
"2011","Shenstone BUA","E34003716","Total",2220,1089,1131,2192,28,46,97.75,22.7
"2011","Turners Hill BUA","E34003717","Total",885,453,432,885,0,14,36.00,24.6
"2011","Abberton BUA","E34003718","Total",831,411,420,803,28,14,50.75,16.4
"2011","West Ashton BUA","E34003719","Total",467,226,241,467,0,13,21.25,22.0
"2011","Lydd BUA","E34003720","Total",3889,1966,1923,3816,73,19,134.25,29.0
"2011","Chelford BUA","E34003721","Total",1058,507,551,1058,0,21,50.25,21.1
"2011","Hoghton BUA","E34003722","Total",524,247,277,524,0,13,24.75,21.2
"2011","Congleton BUA","E34003723","Total",26178,12883,13295,25842,336,338,789.25,33.2
"2011","Offham BUA","E34003724","Total",483,229,254,483,0,10,36.00,13.4
"2011","Ludgershall (Aylesbury Vale) BUA","E34003725","Total",409,216,193,409,0,17,32.25,12.7
"2011","Steeple Claydon BUA","E34003726","Total",2114,1071,1043,2114,0,37,68.50,30.9
"2011","Staverton BUA","E34003727","Total",458,225,233,458,0,13,26.00,17.6
"2011","Tivetshall St Margaret BUA","E34003728","Total",296,138,158,293,3,2,23.75,12.5
"2011","Whitmore BUA","E34003729","Total",142,74,68,142,0,4,26.50,5.4
"2011","Lydden BUA","E34003730","Total",673,344,329,673,0,9,32.75,20.5
"2011","Durley BUA","E34003731","Total",298,151,147,298,0,7,25.00,11.9
"2011","Petworth BUA","E34003732","Total",2544,1179,1365,2475,69,27,78.50,32.4
"2011","Mark BUA","E34003733","Total",741,383,358,680,61,4,29.75,24.9
"2011","Stanton (Tewkesbury) BUA","E34003734","Total",198,92,106,198,0,9,22.25,8.9
"2011","Ampney Crucis BUA","E34003735","Total",636,318,318,636,0,15,42.75,14.9
"2011","North Kyme BUA","E34003736","Total",431,216,215,429,2,1,22.25,19.4
"2011","Woolavington BUA","E34003737","Total",2115,992,1123,2115,0,13,65.75,32.2
"2011","Kington BUA","E34003738","Total",2626,1224,1402,2564,62,39,104.25,25.2
"2011","Mawgan Porth BUA","E34003739","Total",303,149,154,266,37,1,41.50,7.3
"2011","Middleton (Suffolk Coastal) BUA","E34003740","Total",343,158,185,323,20,7,24.00,14.3
"2011","Rishton BUA","E34003741","Total",6625,3296,3329,6623,2,53,113.50,58.4
"2011","Todmorden BUA","E34003742","Total",11690,5598,6092,11497,193,139,342.25,34.2
"2011","Stocksbridge BUA","E34003743","Total",13069,6404,6665,12921,148,118,363.50,36.0
"2011","Heybrook Bay BUA","E34003744","Total",472,221,251,472,0,1,24.75,19.1
"2011","Reawla BUA","E34003745","Total",997,509,488,997,0,10,39.25,25.4
"2011","Frisby on the Wreake BUA","E34003746","Total",557,272,285,557,0,11,25.50,21.8
"2011","Oxenhope BUA","E34003747","Total",1872,884,988,1872,0,34,64.75,28.9
"2011","Bredgar BUA","E34003748","Total",443,221,222,443,0,9,26.50,16.7
"2011","Shifnal BUA","E34003749","Total",6240,3083,3157,6210,30,89,160.50,38.9
"2011","Twyford (Wokingham) BUA","E34003750","Total",7533,3671,3862,7492,41,105,211.00,35.7
"2011","Burnhope BUA","E34003751","Total",1421,694,727,1421,0,5,51.75,27.5
"2011","Tilney St Lawrence BUA","E34003752","Total",1448,681,767,1416,32,14,81.75,17.7
"2011","Everthorpe Hall BUA","E34003753","Total",1263,987,276,566,697,7,23.00,54.9
"2011","Brompton-on-Swale BUA","E34003754","Total",1879,909,970,1877,2,41,79.75,23.6
"2011","Stonely BUA","E34003755","Total",374,178,196,374,0,12,39.00,9.6
"2011","Spennymoor BUA","E34003756","Total",17766,8712,9054,17720,46,151,538.50,33.0
"2011","Long Lartin Prison BUA","E34003757","Total",518,455,63,118,400,0,24.00,21.6
"2011","Ashwell BUA","E34003758","Total",1870,878,992,1869,1,48,75.00,24.9
"2011","Witheridge BUA","E34003759","Total",1158,552,606,1137,21,8,44.50,26.0
"2011","West Wratting BUA","E34003760","Total",502,256,246,488,14,18,28.00,17.9
"2011","Stubbington BUA","E34003761","Total",24644,11771,12873,24380,264,388,661.00,37.3
"2011","Bishop Wilton BUA","E34003762","Total",554,279,275,554,0,17,23.00,24.1
"2011","Stone (Aylesbury Vale) BUA","E34003763","Total",2019,971,1048,1967,52,48,70.00,28.8
"2011","Enham Alamein BUA","E34003764","Total",804,396,408,747,57,12,42.50,18.9
"2011","Long Melford BUA","E34003765","Total",2898,1410,1488,2844,54,35,99.25,29.2
"2011","West Felton BUA","E34003766","Total",720,342,378,720,0,6,33.50,21.5
"2011","Hurstbourne Tarrant BUA","E34003767","Total",676,328,348,676,0,11,44.50,15.2
"2011","Hobson BUA","E34003768","Total",694,349,345,679,15,9,25.50,27.2
"2011","Alton (East Hampshire) BUA","E34003769","Total",18261,8872,9389,17901,360,292,523.00,34.9
"2011","Whimple BUA","E34003770","Total",1173,543,630,1168,5,15,39.75,29.5
"2011","Raskelf BUA","E34003771","Total",519,267,252,515,4,9,22.50,23.1
"2011","Blidworth BUA","E34003772","Total",4457,2178,2279,4395,62,30,128.00,34.8
"2011","Forest Hill BUA","E34003773","Total",551,254,297,551,0,13,24.50,22.5
"2011","Radlett BUA","E34003774","Total",8163,4038,4125,8148,15,291,322.75,25.3
"2011","Buxted BUA","E34003775","Total",1831,912,919,1823,8,46,122.00,15.0
"2011","Hurst BUA","E34003776","Total",1351,656,695,1351,0,35,68.00,19.9
"2011","Fovant BUA","E34003777","Total",669,319,350,669,0,15,48.50,13.8
"2011","Kimpton BUA","E34003778","Total",1436,714,722,1436,0,35,50.00,28.7
"2011","Carhampton BUA","E34003779","Total",687,319,368,687,0,5,34.75,19.8
"2011","Morland BUA","E34003780","Total",374,187,187,374,0,11,21.50,17.4
"2011","Cade Street BUA","E34003781","Total",307,153,154,307,0,8,27.75,11.1
"2011","Hazelwood BUA","E34003782","Total",301,143,158,301,0,5,25.00,12.0
"2011","Dunchurch BUA","E34003783","Total",2405,1173,1232,2329,76,72,91.50,26.3
"2011","Longden BUA","E34003784","Total",332,170,162,332,0,12,24.00,13.8
"2011","Colburn BUA","E34003785","Total",3686,1779,1907,3637,49,36,82.00,45.0
"2011","Wicken (South Northamptonshire) BUA","E34003786","Total",295,147,148,295,0,13,21.50,13.7
"2011","Blackmore BUA","E34003787","Total",829,397,432,829,0,14,25.75,32.2
"2011","Thaxted BUA","E34003788","Total",2538,1227,1311,2493,45,51,78.75,32.2
"2011","Leaden Roding BUA","E34003789","Total",616,309,307,616,0,3,20.50,30.0
"2011","Newton Flotman BUA","E34003790","Total",1489,707,782,1454,35,15,55.25,27.0
"2011","Kingsley (Staffordshire Moorlands) BUA","E34003791","Total",716,341,375,716,0,9,33.25,21.5
"2011","Woolton Hill BUA","E34003792","Total",2626,1257,1369,2564,62,94,158.00,16.6
"2011","Withernsea BUA","E34003793","Total",6159,3052,3107,6026,133,35,168.25,36.6
"2011","Princetown BUA","E34003794","Total",1366,914,452,877,489,8,46.00,29.7
"2011","Padbury BUA","E34003795","Total",810,396,414,810,0,15,39.00,20.8
"2011","Brixton BUA","E34003796","Total",1252,598,654,1228,24,16,48.75,25.7
"2011","Tanworth-in-Arden BUA","E34003797","Total",219,99,120,219,0,2,29.50,7.4
"2011","Bradwell (Braintree) BUA","E34003798","Total",509,262,247,509,0,4,20.25,25.1
"2011","Blackborough End BUA","E34003799","Total",259,122,137,259,0,4,23.00,11.3
"2011","Trimdon Grange BUA","E34003800","Total",1304,646,658,1285,19,9,30.00,43.5
"2011","Lynsted BUA","E34003801","Total",619,298,321,599,20,8,22.25,27.8
"2011","Weston-on-the-Green BUA","E34003802","Total",523,250,273,521,2,16,35.50,14.7
"2011","Haddenham (Aylesbury Vale) BUA","E34003803","Total",4391,2123,2268,4377,14,97,147.50,29.8
"2011","Neston BUA","E34003804","Total",15064,7250,7814,14990,74,232,493.00,30.6
"2011","Barwick BUA","E34003805","Total",1115,538,577,1115,0,10,34.50,32.3
"2011","Elvington BUA","E34003806","Total",933,449,484,933,0,17,31.50,29.6
"2011","Deeping St Nicholas BUA","E34003807","Total",1345,655,690,1345,0,14,55.50,24.2
"2011","Eccleshall BUA","E34003808","Total",2651,1265,1386,2645,6,52,82.00,32.3
"2011","Middlewich BUA","E34003809","Total",13595,6714,6881,13490,105,146,389.75,34.9
"2011","Stoke-by-Clare BUA","E34003810","Total",512,242,270,501,11,9,21.25,24.1
"2011","Wellington Heath BUA","E34003811","Total",440,215,225,424,16,9,37.75,11.7
"2011","Wansford BUA","E34003812","Total",472,235,237,472,0,9,27.00,17.5
"2011","Fulbeck BUA","E34003813","Total",373,187,186,373,0,5,23.50,15.9
"2011","Chilworth BUA","E34003814","Total",1852,879,973,1852,0,39,82.75,22.4
"2011","Ashington (Horsham) BUA","E34003815","Total",2526,1264,1262,2526,0,39,98.25,25.7
"2011","Hemingford Abbots BUA","E34003816","Total",635,316,319,635,0,8,48.00,13.2
"2011","Winkleigh BUA","E34003817","Total",1305,640,665,1298,7,14,44.50,29.3
"2011","Rawreth BUA","E34003818","Total",304,165,139,304,0,1,24.50,12.4
"2011","Winterton BUA","E34003819","Total",4899,2433,2466,4878,21,43,150.50,32.6
"2011","Moggerhanger BUA","E34003820","Total",620,302,318,620,0,7,29.50,21.0
"2011","Southwick (Winchester) BUA","E34003821","Total",689,347,342,548,141,8,47.25,14.6
"2011","Skellingthorpe Big Wood BUA","E34003822","Total",106,52,54,106,0,0,20.25,5.2
"2011","Saxlingham Nethergate BUA","E34003823","Total",688,338,350,655,33,20,32.25,21.3
"2011","Barton St David BUA","E34003824","Total",561,275,286,561,0,24,28.00,20.0
"2011","Worlingworth BUA","E34003825","Total",802,412,390,802,0,19,27.25,29.4
"2011","Alvechurch BUA","E34003826","Total",3534,1676,1858,3501,33,68,100.25,35.3
"2011","Wiggenhall St Germans BUA","E34003827","Total",761,386,375,761,0,16,29.00,26.2
"2011","Feltwell BUA","E34003828","Total",2635,1294,1341,2614,21,25,155.50,16.9
"2011","Singleton BUA","E34003829","Total",480,228,252,458,22,13,21.75,22.1
"2011","Hixon BUA","E34003830","Total",1917,926,991,1870,47,25,106.50,18.0
"2011","Meriden BUA","E34003831","Total",1753,835,918,1745,8,11,68.00,25.8
"2011","Stratton BUA","E34003832","Total",2570,1236,1334,2569,1,51,80.00,32.1
"2011","Eccles on Sea BUA","E34003833","Total",334,178,156,334,0,4,32.25,10.4
"2011","Poulshot BUA","E34003834","Total",370,179,191,370,0,8,22.50,16.4
"2011","Henham BUA","E34003835","Total",924,447,477,924,0,34,50.25,18.4
"2011","Silverdale BUA","E34003836","Total",1326,644,682,1282,44,25,101.50,13.1
"2011","Wold Newton BUA","E34003837","Total",337,168,169,337,0,6,20.25,16.6
"2011","Morley BUA","E34003838","Total",244,124,120,238,6,5,29.00,8.4
"2011","Upton (West Lindsey) BUA","E34003839","Total",456,213,243,456,0,11,30.50,15.0
"2011","Highsted BUA","E34003840","Total",420,203,217,420,0,7,26.25,16.0
"2011","Bow BUA","E34003841","Total",1095,530,565,1088,7,16,46.50,23.5
"2011","Guyhirn BUA","E34003842","Total",333,175,158,333,0,3,56.75,5.9
"2011","Chiserley BUA","E34003843","Total",669,315,354,669,0,14,24.50,27.3
"2011","Walton-on-Thames BUA","E34003844","Total",1176,575,601,1176,0,15,24.75,47.5
"2011","Avening BUA","E34003845","Total",1031,527,504,1026,5,14,42.75,24.1
"2011","Stuston BUA","E34003846","Total",194,103,91,194,0,3,21.50,9.0
"2011","Great Broughton (Allerdale) BUA","E34003847","Total",1704,838,866,1701,3,29,54.00,31.6
"2011","Terrington St Clement BUA","E34003848","Total",3301,1585,1716,3264,37,29,173.75,19.0
"2011","Aldeburgh Road, nr Leiston BUA","E34003849","Total",240,110,130,211,29,0,25.50,9.4
"2011","Starcross BUA","E34003850","Total",1737,835,902,1723,14,15,42.75,40.6
"2011","Edenbridge BUA","E34003851","Total",8172,3910,4262,8076,96,86,236.50,34.6
"2011","Orton BUA","E34003852","Total",235,110,125,234,1,2,22.75,10.3
"2011","St Erth BUA","E34003853","Total",1046,505,541,1041,5,11,25.25,41.4
"2011","Welbourn BUA","E34003854","Total",647,297,350,599,48,14,40.00,16.2
"2011","Chipperfield (Dacorum) BUA","E34003855","Total",1330,673,657,1330,0,31,114.00,11.7
"2011","Blakeney (North Norfolk) BUA","E34003856","Total",801,385,416,791,10,14,76.25,10.5
"2011","Cudworth BUA","E34003857","Total",327,166,161,327,0,6,25.50,12.8
"2011","Leintwardine BUA","E34003858","Total",592,290,302,592,0,16,32.75,18.1
"2011","Butleigh BUA","E34003859","Total",712,335,377,698,14,19,48.75,14.6
"2011","Catworth BUA","E34003860","Total",347,167,180,347,0,13,25.50,13.6
"2011","Sutton (Chichester) BUA","E34003861","Total",425,180,245,370,55,17,22.00,19.3
"2011","Maryport BUA","E34003862","Total",9555,4686,4869,9407,148,94,219.75,43.5
"2011","Winterbourne Abbas BUA","E34003863","Total",652,302,350,584,68,11,32.75,19.9
"2011","Wymondham (South Norfolk) BUA","E34003864","Total",13587,6540,7047,13497,90,189,414.50,32.8
"2011","Ellesmere BUA","E34003865","Total",3686,1789,1897,3650,36,51,110.25,33.4
"2011","Creswell BUA","E34003866","Total",5417,2631,2786,5356,61,21,123.00,44.0
"2011","Egginton BUA","E34003867","Total",574,278,296,574,0,20,29.25,19.6
"2011","Yarnfield BUA","E34003868","Total",1453,746,707,1453,0,31,59.00,24.6
"2011","Woodmancote BUA","E34003869","Total",285,140,145,275,10,6,29.00,9.8
"2011","Stourton Caundle BUA","E34003870","Total",439,217,222,439,0,17,26.50,16.6
"2011","Ditchingham BUA","E34003871","Total",1899,952,947,1858,41,34,79.50,23.9
"2011","Burton Joyce BUA","E34003872","Total",3752,1818,1934,3741,11,62,175.75,21.3
"2011","Sedlescombe BUA","E34003873","Total",891,430,461,890,1,8,41.50,21.5
"2011","Wetwang BUA","E34003874","Total",761,358,403,761,0,12,30.75,24.7
"2011","Upper Oddington BUA","E34003875","Total",417,202,215,417,0,13,37.25,11.2
"2011","Froggatt BUA","E34003876","Total",204,96,108,204,0,11,33.00,6.2
"2011","Higher Folds BUA","E34003877","Total",2552,1312,1240,2552,0,15,45.50,56.1
"2011","Perry Green BUA","E34003878","Total",516,230,286,343,173,12,20.75,24.9
"2011","Longnewton BUA","E34003879","Total",828,420,408,828,0,10,29.50,28.1
"2011","Northaw BUA","E34003880","Total",590,306,284,589,1,9,26.75,22.1
"2011","Corbridge BUA","E34003881","Total",2946,1402,1544,2899,47,54,107.50,27.4
"2011","Quarndon BUA","E34003882","Total",933,476,457,933,0,33,62.50,14.9
"2011","Stillington (Hambleton) BUA","E34003883","Total",782,372,410,782,0,10,28.75,27.2
"2011","Chilcompton BUA","E34003884","Total",2062,1029,1033,2062,0,46,103.25,20.0
"2011","Westerleigh BUA","E34003885","Total",575,281,294,575,0,9,24.75,23.2
"2011","Bampton (West Oxfordshire) BUA","E34003886","Total",2564,1253,1311,2534,30,38,76.00,33.7
"2011","Millbrook BUA","E34003887","Total",2278,1099,1179,2278,0,23,66.75,34.1
"2011","Warthill BUA","E34003888","Total",240,117,123,240,0,8,20.25,11.9
"2011","Holy Cross BUA","E34003889","Total",578,280,298,562,16,11,43.25,13.4
"2011","Towersey BUA","E34003890","Total",433,213,220,433,0,8,25.00,17.3
"2011","Micheldever BUA","E34003891","Total",471,216,255,471,0,0,31.00,15.2
"2011","Saltash BUA","E34003892","Total",15566,7532,8034,15537,29,185,383.00,40.6
"2011","Blockley BUA","E34003893","Total",1104,533,571,1097,7,17,59.50,18.6
"2011","Horton (South Somerset) BUA","E34003894","Total",1391,658,733,1352,39,22,67.50,20.6
"2011","Beal BUA","E34003895","Total",471,236,235,471,0,8,25.75,18.3
"2011","Roxwell BUA","E34003896","Total",381,189,192,381,0,3,24.00,15.9
"2011","Harrold BUA","E34003897","Total",1691,817,874,1684,7,21,62.75,26.9
"2011","Cheriton Fitzpaine BUA","E34003898","Total",556,272,284,556,0,8,24.75,22.5
"2011","Templecombe BUA","E34003899","Total",1560,760,800,1548,12,19,60.25,25.9
"2011","Hunsdon BUA","E34003900","Total",901,455,446,901,0,17,30.75,29.3
"2011","Denham BUA","E34003901","Total",1432,711,721,1421,11,22,73.50,19.5
"2011","Broad Hinton BUA","E34003902","Total",650,321,329,650,0,26,37.25,17.4
"2011","Hertford Heath BUA","E34003903","Total",2672,1340,1332,2216,456,82,84.50,31.6
"2011","Potters Bar BUA","E34003904","Total",22639,10654,11985,22418,221,360,597.75,37.9
"2011","Laughton en le Morthen BUA","E34003905","Total",971,476,495,971,0,7,35.25,27.5
"2011","Upper Caldecote BUA","E34003906","Total",1218,602,616,1218,0,16,47.75,25.5
"2011","Woodstock (West Oxfordshire) BUA","E34003907","Total",2521,1170,1351,2467,54,35,83.25,30.3
"2011","Minster Lovell BUA","E34003908","Total",1236,604,632,1236,0,13,76.75,16.1
"2011","The Wells BUA","E34003909","Total",1354,640,714,1336,18,16,23.25,58.2
"2011","Clampits BUA","E34003910","Total",323,157,166,323,0,5,26.50,12.2
"2011","Seavington St Michael BUA","E34003911","Total",127,61,66,127,0,5,25.50,5.0
"2011","Nether Broughton BUA","E34003912","Total",453,225,228,453,0,7,28.00,16.2
"2011","Heath End BUA","E34003913","Total",367,177,190,367,0,9,22.75,16.1
"2011","King's Somborne BUA","E34003914","Total",1227,593,634,1227,0,38,56.50,21.7
"2011","Wereham BUA","E34003915","Total",660,323,337,660,0,5,43.25,15.3
"2011","Shabbington BUA","E34003916","Total",486,230,256,486,0,15,21.75,22.3
"2011","Headley (Basingstoke and Deane) BUA","E34003917","Total",676,344,332,627,49,15,33.50,20.2
"2011","Banwell BUA","E34003918","Total",1956,941,1015,1956,0,25,90.50,21.6
"2011","Marcham BUA","E34003919","Total",1740,941,799,1523,217,27,50.75,34.3
"2011","Winsham BUA","E34003920","Total",748,358,390,748,0,12,22.25,33.6
"2011","Bentley (East Hampshire) BUA","E34003921","Total",1166,523,643,1049,117,27,46.75,24.9
"2011","Pembury BUA","E34003922","Total",6128,2986,3142,5924,204,137,178.00,34.4
"2011","Burghill BUA","E34003923","Total",190,93,97,190,0,2,29.75,6.4
"2011","Newton St Cyres BUA","E34003924","Total",562,272,290,562,0,16,22.00,25.5
"2011","Eythorne BUA","E34003925","Total",1520,747,773,1520,0,16,60.25,25.2
"2011","Isleham BUA","E34003926","Total",2228,1105,1123,2228,0,43,83.50,26.7
"2011","Bishopstone BUA","E34003927","Total",424,203,221,422,2,14,33.50,12.7
"2011","Clevedon BUA","E34003928","Total",21002,10079,10923,20394,608,270,505.00,41.6
"2011","Burrington BUA","E34003929","Total",237,116,121,237,0,10,24.00,9.9
"2011","Carnkie BUA","E34003930","Total",279,131,148,279,0,6,20.25,13.8
"2011","Ubley BUA","E34003931","Total",331,161,170,331,0,13,26.50,12.5
"2011","Huby (Hambleton) BUA","E34003932","Total",1015,475,540,1013,2,19,50.00,20.3
"2011","Kingsland BUA","E34003933","Total",474,220,254,454,20,6,43.00,11.0
"2011","Hoo Marina Park BUA","E34003934","Total",717,360,357,717,0,3,21.25,33.7
"2011","Tytherington BUA","E34003935","Total",666,342,324,666,0,11,36.00,18.5
"2011","Langworth BUA","E34003936","Total",460,237,223,460,0,2,22.75,20.2
"2011","St Buryan BUA","E34003937","Total",691,353,338,671,20,3,24.00,28.8
"2011","Goulceby BUA","E34003938","Total",294,145,149,294,0,5,30.75,9.6
"2011","South Godstone BUA","E34003939","Total",1461,702,759,1461,0,17,35.75,40.9
"2011","Anstey BUA","E34003940","Total",6528,3137,3391,6521,7,57,135.75,48.1
"2011","Brent Knoll BUA","E34003941","Total",1271,608,663,1206,65,25,75.50,16.8
"2011","North Moreton BUA","E34003942","Total",328,158,170,328,0,15,33.75,9.7
"2011","Lower Moor BUA","E34003943","Total",679,338,341,679,0,12,21.75,31.2
"2011","Alvescot BUA","E34003944","Total",472,242,230,472,0,11,25.50,18.5
"2011","Boosbeck BUA","E34003945","Total",1168,596,572,1168,0,4,25.75,45.4
"2011","St Tudy BUA","E34003946","Total",604,310,294,604,0,10,34.75,17.4
"2011","Hawes BUA","E34003947","Total",887,442,445,883,4,12,42.75,20.7
"2011","Moss BUA","E34003948","Total",389,210,179,389,0,4,26.25,14.8
"2011","Roos BUA","E34003949","Total",846,425,421,846,0,6,39.75,21.3
"2011","Docking BUA","E34003950","Total",885,417,468,832,53,10,65.25,13.6
"2011","Goostrey BUA","E34003951","Total",2008,980,1028,2008,0,45,98.00,20.5
"2011","Hartpury BUA","E34003952","Total",699,336,363,696,3,12,39.25,17.8
"2011","Staveley BUA","E34003953","Total",1384,673,711,1362,22,28,51.50,26.9
"2011","Mersham BUA","E34003954","Total",806,383,423,793,13,9,37.25,21.6
"2011","Aslackby BUA","E34003955","Total",251,120,131,251,0,9,25.50,9.8
"2011","Hebden Bridge BUA","E34003956","Total",4235,2014,2221,4235,0,64,105.25,40.2
"2011","Barlestone BUA","E34003957","Total",2607,1286,1321,2607,0,37,71.75,36.3
"2011","Sticker BUA","E34003958","Total",813,399,414,813,0,4,35.75,22.7
"2011","Yardley Gobion BUA","E34003959","Total",1348,663,685,1302,46,33,35.75,37.7
"2011","Stainton BUA","E34003960","Total",770,372,398,770,0,23,40.25,19.1
"2011","Hallatrow BUA","E34003961","Total",465,243,222,465,0,5,22.25,20.9
"2011","Spixworth BUA","E34003962","Total",3598,1786,1812,3534,64,19,99.75,36.1
"2011","Holcombe BUA","E34003963","Total",947,475,472,947,0,14,54.25,17.5
"2011","Old Alresford BUA","E34003964","Total",577,268,309,546,31,26,37.50,15.4
"2011","Caythorpe BUA","E34003965","Total",1374,668,706,1344,30,19,62.25,22.1
"2011","Little Plumstead (South) BUA","E34003966","Total",776,399,377,748,28,10,27.25,28.5
"2011","Mount Hawke BUA","E34003967","Total",1511,667,844,1511,0,13,47.00,32.1
"2011","Withernwick BUA","E34003968","Total",453,228,225,451,2,5,26.00,17.4
"2011","St Teath BUA","E34003969","Total",633,300,333,622,11,1,24.50,25.8
"2011","Stamford Bridge BUA","E34003970","Total",3528,1667,1861,3460,68,58,103.75,34.0
"2011","Askam in Furness BUA","E34003971","Total",3274,1627,1647,3242,32,43,90.00,36.4
"2011","Hannington BUA","E34003972","Total",493,251,242,493,0,23,23.00,21.4
"2011","Cransford BUA","E34003973","Total",162,81,81,162,0,0,21.25,7.6
"2011","Iwerne Minster BUA","E34003974","Total",978,508,470,661,317,24,44.00,22.2
"2011","Great Chesterford BUA","E34003975","Total",1494,734,760,1493,1,44,65.00,23.0
"2011","Chedworth BUA","E34003976","Total",802,395,407,800,2,22,54.25,14.8
"2011","Takeley BUA","E34003977","Total",3387,1688,1699,3387,0,35,140.50,24.1
"2011","Blofield Heath BUA","E34003978","Total",1367,656,711,1365,2,25,77.50,17.6
"2011","Hindringham BUA","E34003979","Total",457,226,231,457,0,10,29.00,15.8
"2011","Hursley BUA","E34003980","Total",443,225,218,441,2,9,38.25,11.6
"2011","Sulgrave BUA","E34003981","Total",380,173,207,380,0,12,34.75,10.9
"2011","Aldbury BUA","E34003982","Total",642,310,332,642,0,21,30.50,21.0
"2011","Wigginton BUA","E34003983","Total",804,372,432,804,0,20,34.75,23.1
"2011","Great Finborough BUA","E34003984","Total",808,383,425,741,67,7,28.25,28.6
"2011","Fenny Drayton BUA","E34003985","Total",517,259,258,517,0,13,22.00,23.5
"2011","Sharnbrook BUA","E34003986","Total",1795,860,935,1767,28,64,83.00,21.6
"2011","Drayton (Vale of White Horse) BUA","E34003987","Total",2353,1152,1201,2353,0,54,87.25,27.0
"2011","Treeton BUA","E34003988","Total",3189,1523,1666,3134,55,23,67.50,47.2
"2011","Great Torrington BUA","E34003989","Total",5714,2716,2998,5619,95,59,150.75,37.9
"2011","Hornby BUA","E34003990","Total",468,217,251,455,13,9,20.25,23.1
"2011","Riseley BUA","E34003991","Total",1286,638,648,1268,18,35,62.00,20.7
"2011","Farmborough BUA","E34003992","Total",847,422,425,847,0,14,45.50,18.6
"2011","Polebrook BUA","E34003993","Total",478,229,249,435,43,16,32.00,14.9
"2011","Dundon BUA","E34003994","Total",351,173,178,351,0,5,20.75,16.9
"2011","Aston (Cheshire East) BUA","E34003995","Total",392,186,206,392,0,8,28.50,13.8
"2011","Luston BUA","E34003996","Total",541,266,275,541,0,15,23.75,22.8
"2011","East Studdal BUA","E34003997","Total",502,266,236,502,0,7,29.25,17.2
"2011","Curdworth BUA","E34003998","Total",1115,554,561,1115,0,12,45.25,24.6
"2011","Haswell BUA","E34003999","Total",1248,602,646,1230,18,8,36.25,34.4
"2011","Great Hockham BUA","E34004000","Total",603,292,311,603,0,9,26.25,23.0
"2011","Yelvertoft BUA","E34004001","Total",764,371,393,764,0,22,38.50,19.8
"2011","Flaxton BUA","E34004002","Total",343,165,178,343,0,9,20.25,16.9
"2011","Mulbarton BUA","E34004003","Total",3315,1601,1714,3315,0,44,85.75,38.7
"2011","Southfleet BUA","E34004004","Total",918,421,497,868,50,20,37.50,24.5
"2011","Horsted Keynes BUA","E34004005","Total",1180,588,592,1180,0,31,56.00,21.1
"2011","Wilton (County of Herefordshire) BUA","E34004006","Total",610,294,316,574,36,9,25.00,24.4
"2011","Upton (Broadland) BUA","E34004007","Total",702,334,368,671,31,12,27.00,26.0
"2011","Holton le Clay BUA","E34004008","Total",3691,1827,1864,3691,0,55,118.00,31.3
"2011","Nanpean BUA","E34004009","Total",2563,1255,1308,2563,0,12,102.00,25.1
"2011","Kingsley Holt BUA","E34004010","Total",586,284,302,586,0,6,24.00,24.4
"2011","Cheveley BUA","E34004011","Total",884,446,438,884,0,17,57.50,15.4
"2011","Wroughton BUA","E34004012","Total",6474,3108,3366,6377,97,85,178.00,36.4
"2011","Harthill BUA","E34004013","Total",1684,800,884,1684,0,20,62.75,26.8
"2011","Finningley BUA","E34004014","Total",3525,1726,1799,3519,6,59,433.25,8.1
"2011","Sutton Bridge BUA","E34004015","Total",3882,1916,1966,3850,32,17,117.75,33.0
"2011","Upper Heyford BUA","E34004016","Total",953,475,478,953,0,5,401.50,2.4
"2011","Kingswood (Stroud) BUA","E34004017","Total",1252,642,610,1217,35,26,40.00,31.3
"2011","Great Amwell BUA","E34004018","Total",1098,544,554,1098,0,36,77.50,14.2
"2011","Lower Halstow BUA","E34004019","Total",1180,583,597,1180,0,20,34.00,34.7
"2011","St Mary's Bay BUA","E34004020","Total",3028,1443,1585,2995,33,14,92.25,32.8
"2011","Shropham BUA","E34004021","Total",405,198,207,405,0,1,20.75,19.5
"2011","Matching Green BUA","E34004022","Total",335,159,176,335,0,2,33.50,10.0
"2011","Henbury BUA","E34004023","Total",413,210,203,413,0,9,20.25,20.4
"2011","Stockton on the Forest BUA","E34004024","Total",875,454,421,841,34,10,60.50,14.5
"2011","Broyle Side BUA","E34004025","Total",883,437,446,883,0,12,35.50,24.9
"2011","Shareshill BUA","E34004026","Total",759,374,385,759,0,6,27.75,27.4
"2011","West Rainton BUA","E34004027","Total",2316,1099,1217,2280,36,14,71.00,32.6
"2011","West Bergholt BUA","E34004028","Total",3215,1578,1637,3215,0,49,112.50,28.6
"2011","Hemyock BUA","E34004029","Total",1519,740,779,1519,0,27,53.25,28.5
"2011","Whitley (Selby) BUA","E34004030","Total",755,358,397,755,0,12,32.25,23.4
"2011","North Runcton BUA","E34004031","Total",261,132,129,261,0,6,36.50,7.2
"2011","Earith BUA","E34004032","Total",1606,829,777,1592,14,35,55.25,29.1
"2011","Baschurch BUA","E34004033","Total",1595,763,832,1570,25,37,66.75,23.9
"2011","Whitacre Heath BUA","E34004034","Total",469,238,231,469,0,5,26.75,17.5
"2011","Aston Tirrold BUA","E34004035","Total",552,266,286,552,0,26,48.25,11.4
"2011","Melton (Suffolk Coastal) BUA","E34004036","Total",496,239,257,496,0,17,23.00,21.6
"2011","Ormesby St Margaret BUA","E34004037","Total",2810,1367,1443,2776,34,46,92.00,30.5
"2011","Winfrith Newburgh BUA","E34004038","Total",326,151,175,310,16,4,29.50,11.1
"2011","Cholesbury BUA","E34004039","Total",326,174,152,326,0,16,30.50,10.7
"2011","Dorchester (South Oxfordshire) BUA","E34004040","Total",1041,503,538,1037,4,14,48.50,21.5
"2011","Shipton under Wychwood BUA","E34004041","Total",2892,1385,1507,2863,29,49,126.00,23.0
"2011","Morton-on-Swale BUA","E34004042","Total",536,250,286,536,0,6,21.50,24.9
"2011","Mayfield (East Staffordshire) BUA","E34004043","Total",1125,558,567,1125,0,8,37.25,30.2
"2011","Binbrook BUA","E34004044","Total",892,443,449,892,0,9,37.75,23.6
"2011","Barby BUA","E34004045","Total",955,469,486,955,0,23,45.25,21.1
"2011","Nether Whitacre BUA","E34004046","Total",261,131,130,261,0,11,22.75,11.5
"2011","Swarthmoor BUA","E34004047","Total",1076,508,568,1076,0,17,31.75,33.9
"2011","Langold BUA","E34004048","Total",2472,1233,1239,2466,6,11,60.50,40.9
"2011","Winthorpe BUA","E34004049","Total",650,316,334,626,24,13,40.50,16.0
"2011","Burton Fleming BUA","E34004050","Total",430,202,228,415,15,6,28.50,15.1
"2011","Ellesborough BUA","E34004051","Total",544,275,269,544,0,19,27.50,19.8
"2011","Ashdon BUA","E34004052","Total",553,274,279,551,2,15,24.25,22.8
"2011","Ramsey Island BUA","E34004053","Total",1388,696,692,1388,0,12,53.00,26.2
"2011","Butt's Green BUA","E34004054","Total",277,134,143,277,0,6,44.50,6.2
"2011","Alton (Staffordshire Moorlands) BUA","E34004055","Total",991,482,509,965,26,17,48.50,20.4
"2011","Ashleworth BUA","E34004056","Total",540,268,272,540,0,19,24.50,22.0
"2011","Wrenbury-cum-Frith BUA","E34004057","Total",672,329,343,672,0,10,26.50,25.4
"2011","Collingham BUA","E34004058","Total",2578,1251,1327,2533,45,38,115.25,22.4
"2011","Wolvercote BUA","E34004059","Total",1154,549,605,1154,0,20,22.75,50.7
"2011","Scothern BUA","E34004060","Total",860,409,451,839,21,18,38.50,22.3
"2011","Shepton Beauchamp BUA","E34004061","Total",728,346,382,728,0,13,37.25,19.5
"2011","Lanivet BUA","E34004062","Total",989,475,514,960,29,3,36.75,26.9
"2011","Oldcotes BUA","E34004063","Total",338,179,159,333,5,3,22.25,15.2
"2011","Monkwood (West) BUA","E34004064","Total",418,216,202,418,0,13,52.25,8.0
"2011","Silchester BUA","E34004065","Total",774,393,381,773,1,21,29.00,26.7
"2011","Cowbit BUA","E34004066","Total",1220,601,619,1220,0,20,58.50,20.9
"2011","Parkgate BUA","E34004067","Total",336,169,167,336,0,13,50.00,6.7
"2011","Stoke Orchard BUA","E34004068","Total",435,201,234,435,0,11,21.25,20.5
"2011","Harvington BUA","E34004069","Total",1680,819,861,1680,0,25,57.50,29.2
"2011","Brailsford BUA","E34004070","Total",756,352,404,756,0,8,29.25,25.8
"2011","Seisdon BUA","E34004071","Total",752,373,379,711,41,12,32.50,23.1
"2011","Puckeridge BUA","E34004072","Total",3561,1764,1797,3561,0,46,93.25,38.2
"2011","Treswell BUA","E34004073","Total",211,105,106,211,0,5,20.50,10.3
"2011","Hinton BUA","E34004074","Total",3493,1746,1747,3472,21,52,85.25,41.0
"2011","St Osyth BUA","E34004075","Total",2118,991,1127,2113,5,12,57.25,37.0
"2011","Benwick BUA","E34004076","Total",1137,548,589,1137,0,21,43.75,26.0
"2011","Bledington BUA","E34004077","Total",506,250,256,505,1,5,29.75,17.0
"2011","Haselbury Plucknett BUA","E34004078","Total",744,367,377,744,0,9,40.50,18.4
"2011","Wickham St Paul BUA","E34004079","Total",321,162,159,321,0,8,21.00,15.3
"2011","Langport BUA","E34004080","Total",3063,1486,1577,2919,144,34,145.75,21.0
"2011","Castle Camps BUA","E34004081","Total",684,328,356,684,0,19,24.25,28.2
"2011","Westerfield BUA","E34004082","Total",442,217,225,434,8,14,31.00,14.3
"2011","Chew Stoke BUA","E34004083","Total",776,393,383,774,2,17,49.50,15.7
"2011","Isham BUA","E34004084","Total",771,398,373,771,0,15,35.25,21.9
"2011","Wetherden BUA","E34004085","Total",543,274,269,543,0,15,21.75,25.0
"2011","Owston Ferry BUA","E34004086","Total",1172,571,601,1151,21,14,54.50,21.5
"2011","Murrow BUA","E34004087","Total",792,390,402,792,0,5,44.50,17.8
"2011","Thornford BUA","E34004088","Total",939,452,487,939,0,21,37.25,25.2
"2011","Great Wilbraham BUA","E34004089","Total",654,330,324,654,0,13,38.00,17.2
"2011","Tavistock BUA","E34004090","Total",12280,5825,6455,11876,404,233,387.50,31.7
"2011","Chopwell BUA","E34004091","Total",3096,1550,1546,3096,0,29,68.25,45.4
"2011","Newnham (Daventry) BUA","E34004092","Total",580,282,298,580,0,18,26.50,21.9
"2011","Wooler BUA","E34004093","Total",1983,940,1043,1961,22,16,92.75,21.4
"2011","Tetford BUA","E34004094","Total",464,221,243,448,16,7,35.25,13.2
"2011","Childswickham BUA","E34004095","Total",787,378,409,773,14,10,39.00,20.2
"2011","Cavendish BUA","E34004096","Total",875,420,455,857,18,13,44.50,19.7
"2011","Corringham (West Lindsey) BUA","E34004097","Total",523,260,263,523,0,6,23.50,22.3
"2011","Hadlow Down BUA","E34004098","Total",469,216,253,457,12,13,34.25,13.7
"2011","Codsall BUA","E34004099","Total",11673,5585,6088,11622,51,174,310.75,37.6
"2011","Monk Sherborne BUA","E34004100","Total",266,133,133,266,0,5,22.00,12.1
"2011","Bradworthy BUA","E34004101","Total",650,324,326,645,5,7,31.75,20.5
"2011","Longcot BUA","E34004102","Total",617,320,297,617,0,24,24.75,24.9
"2011","Stoke Wood BUA","E34004103","Total",324,162,162,324,0,9,26.00,12.5
"2011","Kimbolton BUA","E34004104","Total",1103,525,578,1058,45,26,42.00,26.3
"2011","Kidmore End BUA","E34004105","Total",331,170,161,331,0,12,22.75,14.5
"2011","Marnhull BUA","E34004106","Total",1483,708,775,1481,2,40,101.25,14.6
"2011","Battisford Tye BUA","E34004107","Total",458,226,232,458,0,21,25.25,18.1
"2011","Langtoft (East Riding of Yorkshire) BUA","E34004108","Total",492,242,250,491,1,5,22.25,22.1
"2011","Kinoulton BUA","E34004109","Total",868,425,443,868,0,23,40.50,21.4
"2011","Fletching BUA","E34004110","Total",301,160,141,301,0,6,20.50,14.7
"2011","Troston BUA","E34004111","Total",335,163,172,335,0,2,21.50,15.6
"2011","Linkhill BUA","E34004112","Total",370,183,187,370,0,3,21.75,17.0
"2011","Frizington BUA","E34004113","Total",1737,861,876,1737,0,7,52.75,32.9
"2011","Flore BUA","E34004114","Total",1194,594,600,1194,0,24,53.50,22.3
"2011","Brampton (Huntingdonshire) BUA","E34004115","Total",4862,2403,2459,4842,20,127,193.00,25.2
"2011","Lee Mill BUA","E34004116","Total",390,184,206,390,0,1,67.25,5.8
"2011","Acton Bridge BUA","E34004117","Total",417,212,205,413,4,10,26.00,16.0
"2011","Swanton Morley BUA","E34004118","Total",801,380,421,746,55,19,57.50,13.9
"2011","Berrick Salome BUA","E34004119","Total",326,166,160,326,0,20,23.75,13.7
"2011","Wentworth BUA","E34004120","Total",354,161,193,329,25,1,33.25,10.6
"2011","Garboldisham BUA","E34004121","Total",543,271,272,541,2,12,40.00,13.6
"2011","Cockermouth BUA","E34004122","Total",9146,4453,4693,9039,107,170,279.25,32.8
"2011","Wiggenhall St Mary Magdalen BUA","E34004123","Total",729,371,358,729,0,7,30.25,24.1
"2011","North Boarhunt BUA","E34004124","Total",600,289,311,553,47,9,76.00,7.9
"2011","Blandford Forum BUA","E34004125","Total",11694,5832,5862,11545,149,177,279.25,41.9
"2011","Indian Queens BUA","E34004126","Total",3893,1912,1981,3861,32,38,133.25,29.2
"2011","Sherfield on Loddon BUA","E34004127","Total",1505,753,752,1505,0,37,50.75,29.7
"2011","Ryton-on-Dunsmore BUA","E34004128","Total",1813,913,900,1812,1,25,67.75,26.8
"2011","South Cave BUA","E34004129","Total",3879,1879,2000,3845,34,97,151.00,25.7
"2011","Bunwell BUA","E34004130","Total",564,282,282,564,0,11,40.25,14.0
"2011","Wick (Wychavon) BUA","E34004131","Total",480,247,233,425,55,3,39.25,12.2
"2011","Bulphan BUA","E34004132","Total",1032,509,523,1032,0,22,53.75,19.2
"2011","Tibshelf BUA","E34004133","Total",3787,1852,1935,3759,28,35,112.25,33.7
"2011","Sittingbourne BUA","E34004134","Total",48948,23990,24958,48512,436,432,1177.75,41.6
"2011","Warninglid BUA","E34004135","Total",244,125,119,244,0,12,55.50,4.4
"2011","Fen Drayton BUA","E34004136","Total",856,433,423,856,0,11,69.50,12.3
"2011","Colsterworth BUA","E34004137","Total",1245,624,621,1245,0,22,66.50,18.7
"2011","Buxton (High Peak) BUA","E34004138","Total",22115,10865,11250,21582,533,338,538.25,41.1
"2011","Motcombe BUA","E34004139","Total",1014,495,519,1012,2,21,55.75,18.2
"2011","West Hill BUA","E34004140","Total",1727,808,919,1727,0,34,197.25,8.8
"2011","Newhaven BUA","E34004141","Total",13222,6582,6640,13153,69,99,378.00,35.0
"2011","Hadleigh BUA","E34004142","Total",8150,3949,4201,8080,70,128,235.50,34.6
"2011","Thetford BUA","E34004143","Total",24833,12352,12481,24645,188,170,703.50,35.3
"2011","Goudhurst BUA","E34004144","Total",1142,557,585,1134,8,25,99.00,11.5
"2011","Colerne Airfield BUA","E34004145","Total",2677,1437,1240,2386,291,52,171.50,15.6
"2011","Winchcombe BUA","E34004146","Total",4538,2213,2325,4538,0,70,169.75,26.7
"2011","Tollesbury BUA","E34004147","Total",2621,1307,1314,2621,0,42,86.25,30.4
"2011","Woolhampton BUA","E34004148","Total",886,475,411,819,67,17,33.50,26.4
"2011","Billingshurst BUA","E34004149","Total",6911,3393,3518,6851,60,99,213.75,32.3
"2011","Barns Green BUA","E34004150","Total",982,504,478,934,48,26,41.25,23.8
"2011","Annfield Plain BUA","E34004151","Total",10406,5065,5341,10326,80,52,284.00,36.6
"2011","Kingswood (Maidstone) BUA","E34004152","Total",1604,817,787,1594,10,26,116.50,13.8
"2011","Emsworth BUA","E34004153","Total",18777,8950,9827,18371,406,284,616.25,30.5
"2011","Bognor Regis BUA","E34004154","Total",63885,30408,33477,61861,2024,537,1655.76,38.6
"2011","Tarleton BUA","E34004155","Total",8582,4268,4314,8558,24,103,546.50,15.7
"2011","Lilleshall BUA","E34004156","Total",942,461,481,942,0,9,60.50,15.6
"2011","Westbury (Wiltshire) BUA","E34004157","Total",16989,8228,8761,16844,145,189,525.25,32.3
"2011","Wadhurst BUA","E34004158","Total",4051,1928,2123,4020,31,137,256.25,15.8
"2011","Clenchwarton BUA","E34004159","Total",1733,842,891,1733,0,16,79.00,21.9
"2011","Bromeswell BUA","E34004160","Total",314,143,171,314,0,15,44.00,7.1
"2011","Bromley Cross BUA","E34004161","Total",416,213,203,416,0,14,23.25,17.9
"2011","Strensall BUA","E34004162","Total",6047,2928,3119,5896,151,140,180.50,33.5
"2011","Milbourne BUA","E34004163","Total",402,187,215,399,3,11,27.25,14.8
"2011","Dymchurch BUA","E34004164","Total",3263,1586,1677,3181,82,22,154.00,21.2
"2011","Mobberley BUA","E34004165","Total",2034,943,1091,1912,122,25,95.00,21.4
"2011","Mileham BUA","E34004166","Total",563,280,283,563,0,8,41.00,13.7
"2011","Newdigate BUA","E34004167","Total",744,355,389,744,0,17,51.75,14.4
"2011","Keswick (North Norfolk) BUA","E34004168","Total",1458,704,754,1440,18,7,90.25,16.2
"2011","Liss BUA","E34004169","Total",6248,2954,3294,6012,236,121,412.00,15.2
"2011","Towcester BUA","E34004170","Total",9057,4490,4567,9023,34,142,225.25,40.2
"2011","Horton (Windsor and Maidenhead) BUA","E34004171","Total",1033,509,524,1033,0,16,60.00,17.2
"2011","Seascale BUA","E34004172","Total",1754,866,888,1732,22,19,77.50,22.6
"2011","Dalton BUA","E34004173","Total",518,259,259,518,0,10,125.25,4.1
"2011","Thornley BUA","E34004174","Total",2457,1230,1227,2457,0,10,64.75,37.9
"2011","Totnes BUA","E34004175","Total",8076,3760,4316,8024,52,115,246.25,32.8
"2011","Cliffs End BUA","E34004176","Total",2635,1281,1354,2629,6,33,400.50,6.6
"2011","Jaywick BUA","E34004177","Total",4799,2339,2460,4753,46,14,217.00,22.1
"2011","Sharpness BUA","E34004178","Total",1029,531,498,1029,0,9,69.50,14.8
"2011","Treviscoe BUA","E34004179","Total",621,302,319,621,0,2,24.00,25.9
"2011","Kingsley (East Hampshire) BUA","E34004180","Total",607,315,292,606,1,20,28.25,21.5
"2011","Hinckley BUA","E34004181","Total",45249,22307,22942,45006,243,467,1284.75,35.2
"2011","Culworth BUA","E34004182","Total",445,207,238,415,30,11,26.00,17.1
"2011","Rangeworthy BUA","E34004183","Total",500,248,252,500,0,3,47.75,10.5
"2011","Rushmoor BUA","E34004184","Total",886,438,448,771,115,29,69.25,12.8
"2011","Yarm BUA","E34004185","Total",19184,9488,9696,18755,429,339,553.00,34.7
"2011","Prees BUA","E34004186","Total",939,466,473,939,0,13,59.50,15.8
"2011","Princes Risborough BUA","E34004187","Total",8231,3902,4329,8044,187,174,398.25,20.7
"2011","Ramsdell BUA","E34004188","Total",408,213,195,408,0,11,35.50,11.5
"2011","Sturton le Steeple BUA","E34004189","Total",486,249,237,486,0,12,35.25,13.8
"2011","Seaham BUA","E34004190","Total",22373,10916,11457,22072,301,96,487.00,45.9
"2011","Hexham BUA","E34004191","Total",11388,5392,5996,11100,288,259,418.50,27.2
"2011","Scunthorpe BUA","E34004192","Total",79977,39541,40436,79304,673,665,2671.25,29.9
"2011","Belper BUA","E34004193","Total",23417,11480,11937,23137,280,274,622.50,37.6
"2011","Badersfield BUA","E34004194","Total",1609,1079,530,1114,495,14,113.50,14.2
"2011","Pollington BUA","E34004195","Total",834,412,422,833,1,7,41.75,20.0
"2011","Littleport BUA","E34004196","Total",7935,3903,4032,7814,121,50,241.75,32.8
"2011","Freckleton BUA","E34004197","Total",8049,3912,4137,7996,53,94,416.50,19.3
"2011","Paslow Wood Common BUA","E34004198","Total",300,145,155,300,0,5,46.00,6.5
"2011","Perranwell BUA","E34004199","Total",1207,591,616,1207,0,19,86.75,13.9
"2011","East Kirkby BUA","E34004200","Total",303,137,166,266,37,0,41.25,7.3
"2011","Arundel BUA","E34004201","Total",3285,1567,1718,3259,26,43,107.50,30.6
"2011","Cliffe BUA","E34004202","Total",2403,1226,1177,2403,0,25,50.00,48.1
"2011","Ewyas Harold BUA","E34004203","Total",1007,496,511,1007,0,18,63.25,15.9
"2011","Berwick-upon-Tweed BUA","E34004204","Total",13265,6322,6943,12938,327,134,464.00,28.6
"2011","Wickham BUA","E34004205","Total",2060,968,1092,2036,24,31,114.50,18.0
"2011","Hensall BUA","E34004206","Total",852,434,418,852,0,7,49.25,17.3
"2011","Menwith Hill Camp BUA","E34004207","Total",549,294,255,438,111,8,55.75,9.8
"2011","Woodbury Salterton BUA","E34004208","Total",593,300,293,589,4,16,31.75,18.7
"2011","Aldbrough St John BUA","E34004209","Total",392,189,203,392,0,13,22.75,17.2
"2011","Stratford-upon-Avon BUA","E34004210","Total",27830,13424,14406,27338,492,440,846.75,32.9
"2011","Hepworth BUA","E34004211","Total",536,257,279,536,0,4,32.50,16.5
"2011","Wickham Bishops BUA","E34004212","Total",3788,1889,1899,3778,10,65,217.25,17.4
"2011","Wombourne BUA","E34004213","Total",13511,6615,6896,13492,19,166,454.50,29.7
"2011","Scamblesby BUA","E34004214","Total",228,112,116,228,0,6,29.50,7.7
"2011","Little Kingshill BUA","E34004215","Total",1514,744,770,1514,0,71,98.50,15.4
"2011","Upchurch BUA","E34004216","Total",1340,639,701,1340,0,11,43.50,30.8
"2011","Burgess Hill BUA","E34004217","Total",30635,14947,15688,30276,359,387,813.75,37.6
"2011","Spalding BUA","E34004218","Total",31588,15351,16237,31295,293,339,1164.75,27.1
"2011","Morcombelake BUA","E34004219","Total",372,181,191,372,0,3,51.75,7.2
"2011","Frampton on Severn BUA","E34004220","Total",1432,702,730,1375,57,29,71.75,20.0
"2011","Newport (East Riding of Yorkshire) BUA","E34004221","Total",1580,788,792,1580,0,14,90.75,17.4
"2011","Ampthill BUA","E34004222","Total",20026,9983,10043,19956,70,375,484.50,41.3
"2011","Althorne BUA","E34004223","Total",1031,509,522,998,33,1,60.25,17.1
"2011","Barnard Castle BUA","E34004224","Total",7040,3585,3455,6240,800,117,232.50,30.3
"2011","Matlock BUA","E34004225","Total",14956,7294,7662,14750,206,234,550.50,27.2
"2011","Donisthorpe BUA","E34004226","Total",1886,944,942,1886,0,21,67.75,27.8
"2011","Furzehill BUA","E34004227","Total",316,152,164,316,0,5,40.25,7.9
"2011","Aveley BUA","E34004228","Total",7986,3945,4041,7973,13,49,164.25,48.6
"2011","Morpeth BUA","E34004229","Total",14403,6960,7443,13958,445,274,482.00,29.9
"2011","Shenley BUA","E34004230","Total",4306,2053,2253,4146,160,71,89.75,48.0
"2011","Netheravon BUA","E34004231","Total",1321,662,659,1282,39,32,42.50,31.1
"2011","South Mimms BUA","E34004232","Total",874,424,450,874,0,13,41.50,21.1
"2011","Fakenham BUA","E34004233","Total",8285,3967,4318,8180,105,62,335.00,24.7
"2011","Fleet Hargate BUA","E34004234","Total",1209,576,633,1135,74,23,53.50,22.6
"2011","Newton Ferrers BUA","E34004235","Total",1268,609,659,1257,11,42,91.75,13.8
"2011","Kirkbride BUA","E34004236","Total",489,237,252,489,0,16,33.00,14.8
"2011","Bransgore BUA","E34004237","Total",3719,1770,1949,3694,25,75,159.75,23.3
"2011","Ripley BUA","E34004238","Total",1334,663,671,1329,5,21,64.00,20.8
"2011","Saxilby BUA","E34004239","Total",3992,1928,2064,3920,72,44,163.50,24.4
"2011","Lydney BUA","E34004240","Total",8776,4260,4516,8702,74,88,312.75,28.1
"2011","Bunbury BUA","E34004241","Total",1195,582,613,1195,0,38,68.00,17.6
"2011","Cleator Moor BUA","E34004242","Total",6936,3485,3451,6869,67,63,180.75,38.4
"2011","Mylor Bridge BUA","E34004243","Total",1443,664,779,1443,0,18,91.50,15.8
"2011","Aspull BUA","E34004244","Total",4899,2432,2467,4899,0,59,129.00,38.0
"2011","Lydiard Millicent BUA","E34004245","Total",1029,511,518,1029,0,31,59.25,17.4
"2011","Brentwood BUA","E34004246","Total",52586,25427,27159,51983,603,929,1422.75,37.0
"2011","Morton (South Kesteven) BUA","E34004247","Total",2406,1168,1238,2406,0,46,84.00,28.6
"2011","Haytor Vale BUA","E34004248","Total",294,136,158,294,0,12,24.75,11.9
"2011","Swanbourne BUA","E34004249","Total",437,226,211,386,51,16,30.00,14.6
"2011","Appleton BUA","E34004250","Total",915,454,461,915,0,27,58.50,15.6
"2011","Warrington BUA","E34004251","Total",165456,81745,83711,163873,1583,1914,4488.76,36.9
"2011","Coleshill (North Warwickshire) BUA","E34004252","Total",6341,3058,3283,6229,112,59,422.50,15.0
"2011","Lower Stondon BUA","E34004253","Total",3857,1971,1886,3723,134,61,144.25,26.7
"2011","Langham (Colchester) BUA","E34004254","Total",790,394,396,790,0,23,70.00,11.3
"2011","Crossways BUA","E34004255","Total",2267,1089,1178,2261,6,22,95.50,23.7
"2011","Winsford (Cheshire West and Chester) BUA","E34004256","Total",30259,14642,15617,30002,257,289,912.75,33.2
"2011","Oxton BUA","E34004257","Total",568,270,298,568,0,17,32.75,17.3
"2011","Witchford BUA","E34004258","Total",2385,1184,1201,2385,0,50,111.25,21.4
"2011","Wrotham BUA","E34004259","Total",1921,921,1000,1906,15,35,78.25,24.5
"2011","Cranwell RAF College and Airfield BUA","E34004260","Total",1022,568,454,846,176,9,122.50,8.3
"2011","Bovington Camp BUA","E34004261","Total",2586,1435,1151,2338,248,45,148.50,17.4
"2011","Kirkby BUA","E34004262","Total",42744,20105,22639,42647,97,169,1311.75,32.6
"2011","Alcester BUA","E34004263","Total",6939,3364,3575,6879,60,111,234.00,29.7
"2011","Mottram St Andrew BUA","E34004264","Total",281,144,137,281,0,14,47.00,6.0
"2011","Sandy Down BUA","E34004265","Total",433,224,209,433,0,10,60.00,7.2
"2011","Desborough BUA","E34004266","Total",10697,5251,5446,10549,148,113,288.25,37.1
"2011","Biddulph BUA","E34004267","Total",17669,8572,9097,17516,153,141,486.50,36.3
"2011","Woolaston BUA","E34004268","Total",820,398,422,820,0,8,63.75,12.9
"2011","Middleton St George BUA","E34004269","Total",3770,1878,1892,3760,10,44,118.50,31.8
"2011","Featherstone (Wakefield) BUA","E34004270","Total",11060,5341,5719,10995,65,45,299.50,36.9
"2011","Foulridge BUA","E34004271","Total",1159,584,575,1159,0,13,45.75,25.3
"2011","Richings Park BUA","E34004272","Total",1997,1012,985,1997,0,53,93.25,21.4
"2011","Brockley BUA","E34004273","Total",458,223,235,415,43,11,26.50,17.3
"2011","Witney BUA","E34004274","Total",29103,14124,14979,28884,219,462,717.25,40.6
"2011","Ottery St Mary BUA","E34004275","Total",4898,2355,2543,4878,20,82,141.00,34.7
"2011","Hawkhurst BUA","E34004276","Total",3963,1936,2027,3928,35,90,157.50,25.2
"2011","Liskeard BUA","E34004277","Total",9237,4447,4790,9237,0,101,251.00,36.8
"2011","Faversham BUA","E34004278","Total",19829,9539,10290,19664,165,194,438.25,45.2
"2011","Knaith Park BUA","E34004279","Total",335,157,178,335,0,4,30.25,11.1
"2011","St Bees BUA","E34004280","Total",1644,854,790,1561,83,59,70.75,23.2
"2011","Market Harborough BUA","E34004281","Total",22911,11171,11740,22629,282,350,634.50,36.1
"2011","Swanage BUA","E34004282","Total",10454,5034,5420,10242,212,165,341.75,30.6
"2011","Flintham BUA","E34004283","Total",304,154,150,304,0,2,103.25,2.9
"2011","Greystoke BUA","E34004284","Total",654,318,336,654,0,9,28.75,22.7
"2011","Hambledon BUA","E34004285","Total",702,333,369,702,0,15,74.25,9.5
"2011","Bassingbourn Barracks BUA","E34004286","Total",399,244,155,277,122,1,71.50,5.6
"2011","Lydbrook BUA","E34004287","Total",1894,944,950,1877,17,14,158.00,12.0
"2011","Yelverton BUA","E34004288","Total",3627,1706,1921,3484,143,66,152.25,23.8
"2011","Hutton Cranswick BUA","E34004289","Total",1505,701,804,1478,27,33,82.25,18.3
"2011","Bletchingley BUA","E34004290","Total",2221,1063,1158,2219,2,41,91.00,24.4
"2011","Boars Hill BUA","E34004291","Total",561,257,304,523,38,33,168.50,3.3
"2011","Evesham BUA","E34004292","Total",23576,11618,11958,23427,149,266,573.00,41.1
"2011","Canvey Island BUA","E34004293","Total",38170,18664,19506,37962,208,218,751.25,50.8
"2011","Great Malvern BUA","E34004294","Total",36770,17726,19044,35301,1469,623,1352.00,27.2
"2011","Dunkeswell BUA","E34004295","Total",1361,671,690,1361,0,7,136.75,10.0
"2011","Teffont Magna BUA","E34004296","Total",248,119,129,248,0,14,37.75,6.6
"2011","Awbridge BUA","E34004297","Total",712,338,374,702,10,22,52.50,13.6
"2011","Seend BUA","E34004298","Total",267,123,144,267,0,8,44.25,6.0
"2011","Kirton Holme BUA","E34004299","Total",372,188,184,372,0,7,23.50,15.8
"2011","Upwell BUA","E34004300","Total",4278,2094,2184,4278,0,40,278.25,15.4
"2011","Hunwick BUA","E34004301","Total",1248,623,625,1248,0,13,32.25,38.7
"2011","Cambourne BUA","E34004302","Total",8186,4082,4104,8186,0,90,158.50,51.6
"2011","Hellingly BUA","E34004303","Total",286,143,143,254,32,10,23.50,12.2
"2011","Ruishton BUA","E34004304","Total",1473,686,787,1435,38,12,70.00,21.0
"2011","Sutterton BUA","E34004305","Total",1368,668,700,1368,0,8,69.25,19.8
"2011","Salisbury BUA","E34004306","Total",44748,21396,23352,43669,1079,774,1128.25,39.7
"2011","The City BUA","E34004307","Total",499,245,254,499,0,11,64.75,7.7
"2011","Benenden BUA","E34004308","Total",787,384,403,767,20,31,72.50,10.9
"2011","Box Hill BUA","E34004309","Total",1364,701,663,1364,0,8,91.75,14.9
"2011","Holme (Huntingdonshire) BUA","E34004310","Total",636,329,307,636,0,16,185.75,3.4
"2011","Salcombe BUA","E34004311","Total",1909,910,999,1858,51,44,132.75,14.4
"2011","South Hiendley BUA","E34004312","Total",1817,889,928,1817,0,19,52.00,34.9
"2011","St Dennis BUA","E34004313","Total",2319,1117,1202,2319,0,10,76.25,30.4
"2011","Hawley BUA","E34004314","Total",1793,895,898,1752,41,15,33.50,53.5
"2011","Lowestoft BUA","E34004315","Total",70945,34446,36499,70180,765,617,2154.25,32.9
"2011","Leake Commonside BUA","E34004316","Total",457,226,231,457,0,4,40.50,11.3
"2011","Honington Airfield BUA","E34004317","Total",1294,975,319,585,709,22,181.00,7.1
"2011","Lifton BUA","E34004318","Total",1180,585,595,1180,0,14,47.00,25.1
"2011","High Halden BUA","E34004319","Total",1159,566,593,1157,2,23,61.25,18.9
"2011","Bourne End BUA","E34004320","Total",233,114,119,231,2,15,33.25,7.0
"2011","Crewkerne BUA","E34004321","Total",7826,3748,4078,7782,44,71,275.00,28.5
"2011","Ilkley BUA","E34004322","Total",14809,6979,7830,14455,354,420,492.00,30.1
"2011","Little Bealings BUA","E34004323","Total",420,204,216,420,0,21,57.75,7.3
"2011","Belton (North Lincolnshire) BUA","E34004324","Total",2503,1242,1261,2503,0,16,255.50,9.8
"2011","Millison's Wood BUA","E34004325","Total",633,313,320,633,0,7,40.75,15.5
"2011","Shawbury BUA","E34004326","Total",2317,1222,1095,2052,265,35,167.75,13.8
"2011","Skegness BUA","E34004327","Total",24876,11966,12910,23875,1001,174,1179.00,21.1
"2011","Malmesbury BUA","E34004328","Total",6318,3103,3215,6220,98,111,189.50,33.3
"2011","Danbury BUA","E34004329","Total",6673,3313,3360,6638,35,148,431.75,15.5
"2011","Loftus BUA","E34004330","Total",4824,2364,2460,4742,82,13,104.00,46.4
"2011","Hickling (North Norfolk) BUA","E34004331","Total",935,453,482,915,20,11,63.50,14.7
"2011","Spencers Wood BUA","E34004332","Total",4019,2005,2014,3992,27,50,142.75,28.2
"2011","Hydestile BUA","E34004333","Total",338,165,173,338,0,24,22.00,15.4
"2011","Hereford BUA","E34004334","Total",60415,29795,30620,59702,713,724,1705.25,35.4
"2011","Formby BUA","E34004335","Total",23329,11143,12186,23065,264,464,783.50,29.8
"2011","Sandbach BUA","E34004336","Total",17976,8781,9195,17834,142,315,575.75,31.2
"2011","Edwinstowe BUA","E34004337","Total",5188,2531,2657,5105,83,36,145.50,35.7
"2011","St Ives (Cornwall) BUA","E34004338","Total",9966,4681,5285,9648,318,111,297.00,33.6
"2011","Flookburgh BUA","E34004339","Total",1305,639,666,1279,26,11,48.00,27.2
"2011","Pocklington BUA","E34004340","Total",8337,4011,4326,8161,176,134,261.25,31.9
"2011","Cheriton BUA","E34004341","Total",325,155,170,325,0,11,45.50,7.1
"2011","Nalderswood BUA","E34004342","Total",343,171,172,343,0,9,26.75,12.8
"2011","Melton Mowbray BUA","E34004343","Total",27158,13313,13845,26866,292,269,701.00,38.7
"2011","Appledore BUA","E34004344","Total",749,370,379,746,3,16,53.00,14.1
"2011","Brinkworth BUA","E34004345","Total",489,254,235,489,0,14,52.25,9.4
"2011","Catterick Garrison BUA","E34004346","Total",11804,7438,4366,8303,3501,153,437.75,27.0
"2011","Stanton (St. Edmundsbury) BUA","E34004347","Total",2019,1003,1016,2000,19,31,85.25,23.7
"2011","Chappel BUA","E34004348","Total",403,208,195,403,0,19,30.50,13.2
"2011","Tonbridge BUA","E34004349","Total",38657,19020,19637,37998,659,702,967.25,40.0
"2011","Dersingham BUA","E34004350","Total",4640,2148,2492,4618,22,34,177.50,26.1
"2011","Sible Hedingham BUA","E34004351","Total",3702,1812,1890,3669,33,48,170.00,21.8
"2011","Wainfleet All Saints BUA","E34004352","Total",1744,828,916,1703,41,19,83.75,20.8
"2011","Albrighton BUA","E34004353","Total",4829,2307,2522,4816,13,72,131.75,36.7
"2011","Ravenshead BUA","E34004354","Total",5759,2802,2957,5756,3,123,297.00,19.4
"2011","Harwell Science and Innovation Campus BUA","E34004355","Total",179,84,95,179,0,0,116.25,1.5
"2011","Bledlow Ridge BUA","E34004356","Total",748,370,378,748,0,32,81.00,9.2
"2011","Rhodes Minnis BUA","E34004357","Total",171,87,84,171,0,9,23.50,7.3
"2011","Castle Donington BUA","E34004358","Total",6416,3242,3174,6348,68,90,608.50,10.5
"2011","Ewhurst BUA","E34004359","Total",1653,758,895,1626,27,36,101.50,16.3
"2011","Barnston (Wirral) BUA","E34004360","Total",672,330,342,656,16,21,37.75,17.8
"2011","Mayfield (Wealden) BUA","E34004361","Total",2022,939,1083,1938,84,63,143.50,14.1
"2011","Great Leighs BUA","E34004362","Total",2709,1312,1397,2709,0,29,64.00,42.3
"2011","Kirton in Lindsey BUA","E34004363","Total",2873,1405,1468,2852,21,52,141.00,20.4
"2011","Knockholt BUA","E34004364","Total",305,151,154,305,0,5,39.50,7.7
"2011","Lyme Regis BUA","E34004365","Total",4712,2138,2574,4543,169,86,276.50,17.0
"2011","Springvale BUA","E34004366","Total",4901,2383,2518,4730,171,111,178.25,27.5
"2011","Penkridge BUA","E34004367","Total",7791,3805,3986,7779,12,85,202.75,38.4
"2011","Royal National Orthopaedic Hospital BUA","E34004368","Total",601,293,308,598,3,11,41.50,14.5
"2011","Alveston BUA","E34004369","Total",2656,1312,1344,2634,22,44,122.00,21.8
"2011","Crowhurst BUA","E34004370","Total",891,430,461,848,43,8,67.50,13.2
"2011","Bonsall BUA","E34004371","Total",803,408,395,803,0,15,35.50,22.6
"2011","Eynsham BUA","E34004372","Total",4648,2233,2415,4629,19,79,138.00,33.7
"2011","Tebworth BUA","E34004373","Total",475,238,237,475,0,9,33.25,14.3
"2011","Bakewell BUA","E34004374","Total",3949,1809,2140,3722,227,80,190.25,20.8
"2011","Woolpit BUA","E34004375","Total",1753,861,892,1751,2,31,94.25,18.6
"2011","Winwick BUA","E34004376","Total",2435,1196,1239,2306,129,32,71.75,33.9
"2011","Upper Rissington BUA","E34004377","Total",1046,510,536,1046,0,18,94.50,11.1
"2011","South Luffenham BUA","E34004378","Total",455,227,228,455,0,14,26.75,17.0
"2011","Callow Hill BUA","E34004379","Total",953,476,477,952,1,11,133.00,7.2
"2011","Milton BUA","E34004380","Total",170,80,90,170,0,2,24.50,6.9
"2011","Far Forest BUA","E34004381","Total",594,282,312,577,17,9,52.25,11.4
"2011","Donhead St Mary BUA","E34004382","Total",253,115,138,253,0,17,29.50,8.6
"2011","Boston BUA","E34004383","Total",41340,19929,21411,40878,462,390,1328.00,31.1
"2011","Holbeach Clough BUA","E34004384","Total",980,493,487,980,0,11,55.25,17.7
"2011","Mortimer BUA","E34004385","Total",3698,1831,1867,3698,0,69,136.50,27.1
"2011","Cosford Airfield BUA","E34004386","Total",1750,1176,574,1064,686,20,132.75,13.2
"2011","Blakeney (Forest of Dean) BUA","E34004387","Total",1644,809,835,1602,42,20,115.25,14.3
"2011","Crowborough BUA","E34004388","Total",20607,10154,10453,20285,322,403,821.25,25.1
"2011","King's Lynn BUA","E34004389","Total",46093,22540,23553,45559,534,460,1460.75,31.6
"2011","Elmswell BUA","E34004390","Total",3950,1953,1997,3948,2,56,131.00,30.2
"2011","Sissinghurst BUA","E34004391","Total",1068,516,552,1066,2,46,85.50,12.5
"2011","Haywards Heath BUA","E34004392","Total",33845,16455,17390,33477,368,542,935.50,36.2
"2011","Bridgwater BUA","E34004393","Total",41276,20342,20934,40838,438,315,1125.25,36.7
"2011","St Breward BUA","E34004394","Total",600,280,320,589,11,4,37.50,16.0
"2011","Radley BUA","E34004395","Total",1979,1310,669,1338,641,67,65.50,30.2
"2011","Litton Cheney BUA","E34004396","Total",359,174,185,359,0,4,29.00,12.4
"2011","Gainsborough BUA","E34004397","Total",20842,10104,10738,20579,263,157,595.50,35.0
"2011","Dover BUA","E34004398","Total",41709,20788,20921,40958,751,354,1022.75,40.8
"2011","Maidstone BUA","E34004399","Total",107627,53090,54537,105550,2077,1275,2544.75,42.3
"2011","Elvington Airfield BUA","E34004400","Total",306,153,153,306,0,8,114.25,2.7
"2011","Ilchester BUA","E34004401","Total",2153,1069,1084,2153,0,63,60.25,35.7
"2011","Baldwin's Gate BUA","E34004402","Total",926,442,484,926,0,14,70.50,13.1
"2011","Bath BUA","E34004403","Total",94782,46352,48430,90181,4601,1674,2423.75,39.1
"2011","Keele BUA","E34004404","Total",3953,1965,1988,717,3236,79,85.25,46.4
"2011","Caton BUA","E34004405","Total",2387,1139,1248,2387,0,35,83.75,28.5
"2011","Kingstone (County of Herefordshire) BUA","E34004406","Total",1373,681,692,1373,0,25,53.00,25.9
"2011","Brenchley BUA","E34004407","Total",1171,577,594,1170,1,30,117.00,10.0
"2011","Scarborough BUA","E34004408","Total",61749,29854,31895,60041,1708,680,1449.00,42.6
"2011","Oxted BUA","E34004409","Total",13452,6469,6983,13154,298,332,631.75,21.3
"2011","Church Fenton BUA","E34004410","Total",1357,651,706,1357,0,18,118.50,11.5
"2011","Broad Chalke BUA","E34004411","Total",680,329,351,680,0,29,53.75,12.7
"2011","Great Totham BUA","E34004412","Total",735,359,376,735,0,8,70.50,10.4
"2011","Broadwell (West Oxfordshire) BUA","E34004413","Total",101,46,55,101,0,2,22.75,4.4
"2011","Wittering Airfield BUA","E34004414","Total",3099,1718,1381,2619,480,41,210.25,14.7
"2011","Shepton Mallet BUA","E34004415","Total",10369,5233,5136,10115,254,92,308.00,33.7
"2011","Overton (Basingstoke and Deane) BUA","E34004416","Total",3980,1964,2016,3930,50,58,135.75,29.3
"2011","Cranmore BUA","E34004417","Total",316,160,156,316,0,7,63.25,5.0
"2011","West Malling BUA","E34004418","Total",2266,1057,1209,2176,90,36,95.00,23.9
"2011","Marden (County of Herefordshire) BUA","E34004419","Total",972,486,486,787,185,17,47.50,20.5
"2011","Alconbury Airfield BUA","E34004420","Total",620,360,260,270,350,7,387.25,1.6
"2011","Stone (Stafford) BUA","E34004421","Total",16385,7997,8388,16181,204,213,498.75,32.9
"2011","Godmanchester BUA","E34004422","Total",6506,3164,3342,6506,0,114,158.50,41.0
"2011","Markfield BUA","E34004423","Total",4993,2405,2588,4924,69,80,156.00,32.0
"2011","Seaton Sluice BUA","E34004424","Total",3082,1465,1617,3054,28,20,71.75,43.0
"2011","Sywell BUA","E34004425","Total",1117,527,590,1117,0,14,90.50,12.3
"2011","Polesworth BUA","E34004426","Total",9645,4763,4882,9572,73,101,205.00,47.0
"2011","St Michael's on Wyre BUA","E34004427","Total",629,286,343,629,0,10,33.25,18.9
"2011","Chadlington BUA","E34004428","Total",827,390,437,827,0,22,38.50,21.5
"2011","Kingswood (Warwick) BUA","E34004429","Total",1159,585,574,1158,1,36,109.50,10.6
"2011","East Huntspill BUA","E34004430","Total",782,390,392,782,0,11,39.75,19.7
"2011","West Stockwith BUA","E34004431","Total",641,311,330,601,40,7,33.00,19.4
"2011","Castor BUA","E34004432","Total",1393,672,721,1393,0,47,78.25,17.8
"2011","Wood End (North Warwickshire) BUA","E34004433","Total",1940,972,968,1940,0,13,62.50,31.0
"2011","Lympsham BUA","E34004434","Total",618,285,333,605,13,20,53.50,11.6
"2011","Otford BUA","E34004435","Total",7155,3457,3698,7111,44,140,314.50,22.8
"2011","Rendlesham BUA","E34004436","Total",3013,1448,1565,2966,47,30,279.25,10.8
"2011","North Fambridge BUA","E34004437","Total",835,428,407,835,0,14,47.75,17.5
"2011","Pitstone BUA","E34004438","Total",3674,1828,1846,3657,17,60,106.25,34.6
"2011","Smarden BUA","E34004439","Total",614,294,320,614,0,4,57.50,10.7
"2011","Croughton BUA","E34004440","Total",992,505,487,916,76,21,78.50,12.6
"2011","Kingsbridge BUA","E34004441","Total",6116,2880,3236,6034,82,94,187.50,32.6
"2011","Tewkesbury BUA","E34004442","Total",19778,9872,9906,19640,138,200,622.50,31.8
"2011","Stoke Prior BUA","E34004443","Total",1762,873,889,1762,0,13,84.75,20.8
"2011","Worth BUA","E34004444","Total",634,326,308,595,39,5,57.25,11.1
"2011","Summerbridge BUA","E34004445","Total",882,421,461,878,4,14,45.50,19.4
"2011","Stelling Minnis BUA","E34004446","Total",292,145,147,292,0,13,46.00,6.3
"2011","Wilton (Wiltshire) BUA","E34004447","Total",3579,1658,1921,3579,0,91,146.25,24.5
"2011","St Margaret's at Cliffe BUA","E34004448","Total",2499,1208,1291,2491,8,39,130.00,19.2
"2011","Weyhill BUA","E34004449","Total",630,304,326,582,48,15,64.75,9.7
"2011","Almodington BUA","E34004450","Total",459,218,241,430,29,13,77.00,6.0
"2011","Lower Brailes BUA","E34004451","Total",1027,489,538,1027,0,30,67.75,15.2
"2011","Gosforth BUA","E34004452","Total",961,498,463,939,22,11,57.75,16.6
"2011","Bulford Camp BUA","E34004453","Total",8556,4600,3956,7741,815,126,310.75,27.5
"2011","Slip End BUA","E34004454","Total",1358,668,690,1351,7,23,50.75,26.8
"2011","Fivehead BUA","E34004455","Total",609,290,319,609,0,11,41.25,14.8
"2011","Sway BUA","E34004456","Total",2421,1121,1300,2327,94,52,149.50,16.2
"2011","Staplecross BUA","E34004457","Total",760,363,397,760,0,15,25.25,30.1
"2011","West Clandon BUA","E34004458","Total",5422,2648,2774,5347,75,138,335.00,16.2
"2011","Ifold BUA","E34004459","Total",1129,561,568,1129,0,49,98.75,11.4
"2011","Mitcheldean BUA","E34004460","Total",2783,1364,1419,2703,80,27,103.50,26.9
"2011","Dunston BUA","E34004461","Total",770,381,389,722,48,24,53.25,14.5
"2011","Prestwood BUA","E34004462","Total",7501,3600,3901,7448,53,209,326.50,23.0
"2011","Elstead BUA","E34004463","Total",2557,1254,1303,2539,18,59,125.25,20.4
"2011","Chalton BUA","E34004464","Total",538,276,262,538,0,6,45.50,11.8
"2011","West Winch BUA","E34004465","Total",2533,1228,1305,2493,40,25,126.50,20.0
"2011","Cliviger BUA","E34004466","Total",1493,738,755,1493,0,32,42.75,34.9
"2011","Bacton BUA","E34004467","Total",1324,677,647,1324,0,27,78.75,16.8
"2011","Lasham Airfield BUA","E34004468","Total",176,84,92,176,0,7,80.00,2.2
"2011","Thurston BUA","E34004469","Total",2952,1461,1491,2952,0,71,134.50,21.9
"2011","Witham on the Hill BUA","E34004470","Total",260,133,127,213,47,16,23.00,11.3
"2011","Barnstaple BUA","E34004471","Total",31616,15174,16442,31390,226,349,869.25,36.4
"2011","Wynyard Village BUA","E34004472","Total",2462,1208,1254,2424,38,61,121.50,20.3
"2011","Bovey Tracey BUA","E34004473","Total",4729,2260,2469,4710,19,68,175.50,26.9
"2011","Preesall BUA","E34004474","Total",5367,2602,2765,5296,71,49,193.25,27.8
"2011","Ogbourne St Andrew BUA","E34004475","Total",417,206,211,417,0,16,25.50,16.4
"2011","Winsley BUA","E34004476","Total",1677,805,872,1643,34,55,99.50,16.9
"2011","Birdham BUA","E34004477","Total",1166,568,598,1166,0,26,114.00,10.2
"2011","Haverigg BUA","E34004478","Total",1849,1182,667,1312,537,10,74.25,24.9
"2011","Melksham BUA","E34004479","Total",19357,9573,9784,19252,105,204,539.00,35.9
"2011","Beech BUA","E34004480","Total",532,274,258,524,8,23,74.25,7.2
"2011","Gobowen BUA","E34004481","Total",3270,1594,1676,2914,356,29,115.75,28.3
"2011","Chicksands BUA","E34004482","Total",1396,725,671,1197,199,28,72.50,19.3
"2011","Warminster BUA","E34004483","Total",17490,8478,9012,17033,457,308,540.50,32.4
"2011","Bridport BUA","E34004484","Total",13737,6483,7254,13552,185,172,485.75,28.3
"2011","Thame BUA","E34004485","Total",11329,5471,5858,11279,50,253,277.25,40.9
"2011","Kirton (Newark and Sherwood) BUA","E34004486","Total",261,135,126,261,0,3,71.75,3.6
"2011","Durham BUA","E34004487","Total",47785,24049,23736,39968,7817,731,1286.75,37.1
"2011","Wilton Park BUA","E34004488","Total",402,236,166,228,174,14,20.00,20.1
"2011","Wellow (Isle of Wight) BUA","E34004489","Total",304,150,154,304,0,9,20.00,15.2
"2011","Piddlehinton BUA","E34004490","Total",403,195,208,403,0,7,20.00,20.1
"2011","Broad Oak (North Dorset) BUA","E34004491","Total",230,114,116,230,0,9,20.00,11.5
"2011","Lockerley BUA","E34004492","Total",277,124,153,264,13,8,20.00,13.8
"2011","Crockerton BUA","E34004493","Total",273,116,157,273,0,11,20.00,13.7
"2011","Stoke (Basingstoke and Deane) BUA","E34004494","Total",300,146,154,300,0,14,20.00,15.0
"2011","Lockeridge BUA","E34004495","Total",319,151,168,319,0,17,20.00,15.9
"2011","Priston BUA","E34004496","Total",232,123,109,232,0,9,20.00,11.6
"2011","Gundleton BUA","E34004497","Total",341,178,163,341,0,7,20.00,17.1
"2011","Chedzoy BUA","E34004498","Total",404,201,203,400,4,15,20.00,20.2
"2011","Hillesley BUA","E34004499","Total",350,172,178,350,0,8,20.00,17.5
"2011","Nympsfield BUA","E34004500","Total",382,192,190,382,0,12,20.00,19.1
"2011","Kingston Seymour BUA","E34004501","Total",388,184,204,388,0,14,20.00,19.4
"2011","Withington (Cotswold) BUA","E34004502","Total",278,137,141,278,0,7,20.00,13.9
"2011","Binton BUA","E34004503","Total",311,152,159,306,5,12,20.00,15.5
"2011","Chilton (Aylesbury Vale) BUA","E34004504","Total",302,154,148,280,22,8,20.00,15.1
"2011","White Waltham BUA","E34004505","Total",349,175,174,349,0,23,20.00,17.4
"2011","Winsford (West Somerset) BUA","E34004506","Total",321,158,163,316,5,5,20.00,16.1
"2011","Moreton Pinkney BUA","E34004507","Total",371,175,196,371,0,10,20.00,18.6
"2011","Wappenham BUA","E34004508","Total",294,149,145,293,1,15,20.00,14.7
"2011","Eardington BUA","E34004509","Total",530,267,263,530,0,10,20.00,26.5
"2011","Shutlanger BUA","E34004510","Total",290,146,144,290,0,9,20.00,14.5
"2011","Tiffield BUA","E34004511","Total",362,181,181,362,0,9,20.00,18.1
"2011","Aston-By-Stone BUA","E34004512","Total",340,187,153,332,8,11,20.00,17.0
"2011","Exbourne BUA","E34004513","Total",358,183,175,358,0,3,20.00,17.9
"2011","Studham BUA","E34004514","Total",492,242,250,492,0,13,20.00,24.6
"2011","Tur Langton BUA","E34004515","Total",316,150,166,264,52,7,20.00,15.8
"2011","Bicton BUA","E34004516","Total",331,157,174,331,0,8,20.00,16.6
"2011","Little Warford BUA","E34004517","Total",419,226,193,237,182,12,20.00,20.9
"2011","Treburley BUA","E34004518","Total",252,123,129,252,0,3,20.00,12.6
"2011","Penshurst BUA","E34004519","Total",708,343,365,706,2,27,20.00,35.4
"2011","Collyweston BUA","E34004520","Total",514,250,264,514,0,17,20.00,25.7
"2011","Mankinholes BUA","E34004521","Total",377,178,199,372,5,11,20.00,18.9
"2011","Yarwell BUA","E34004522","Total",294,143,151,294,0,11,20.00,14.7
"2011","Little Hadham BUA","E34004523","Total",383,205,178,383,0,8,20.00,19.1
"2011","Burton in Lonsdale BUA","E34004524","Total",579,268,311,579,0,12,20.00,28.9
"2011","Trottiscliffe BUA","E34004525","Total",257,125,132,257,0,2,20.00,12.8
"2011","Holywell (Huntingdonshire) BUA","E34004526","Total",326,168,158,324,2,8,20.00,16.3
"2011","Forton BUA","E34004527","Total",302,157,145,269,33,6,20.00,15.1
"2011","Spridlington BUA","E34004528","Total",213,103,110,213,0,2,20.00,10.7
"2011","Southrey BUA","E34004529","Total",213,102,111,213,0,2,20.00,10.7
"2011","Carlton in Cleveland BUA","E34004530","Total",399,199,200,399,0,14,20.00,19.9
"2011","North Dalton BUA","E34004531","Total",302,154,148,302,0,6,20.00,15.1
"2011","Leverton BUA","E34004532","Total",349,171,178,349,0,5,20.00,17.4
"2011","Great Wratting BUA","E34004533","Total",196,95,101,196,0,5,20.00,9.8
"2011","Alvingham BUA","E34004534","Total",256,129,127,256,0,5,20.00,12.8
"2011","Chilham BUA","E34004535","Total",379,178,201,377,2,6,20.00,18.9
"2011","Dunkirk BUA","E34004536","Total",278,136,142,269,9,1,20.00,13.9
"2011","Beachamwell BUA","E34004537","Total",339,163,176,339,0,5,20.00,16.9
"2011","Wickham Skeith BUA","E34004538","Total",321,159,162,321,0,5,20.00,16.1
"2011","Clint Green BUA","E34004539","Total",378,183,195,378,0,3,20.00,18.9
"2011","Metfield BUA","E34004540","Total",388,192,196,388,0,5,20.00,19.4
"2011","Three Legged Cross BUA","E34004541","Total",1492,692,800,1428,64,19,135.00,11.1
"2011","Curdridge BUA","E34004542","Total",951,456,495,908,43,25,97.50,9.8
"2011","Cranbourne BUA","E34004543","Total",1089,537,552,1089,0,25,72.50,15.0
"2011","Sundridge BUA","E34004544","Total",1383,687,696,1383,0,30,74.75,18.5
"2011","Dunnington BUA","E34004545","Total",3230,1561,1669,3176,54,68,98.25,32.9
"2011","Rowlands Gill BUA","E34004546","Total",6096,2903,3193,6093,3,69,192.50,31.7
"2011","Coalville BUA","E34004547","Total",38245,18843,19402,37981,264,339,1103.00,34.7
"2011","Totton BUA","E34004548","Total",34169,16761,17408,33822,347,352,1032.50,33.1
"2011","Greatham (East Hampshire) BUA","E34004549","Total",447,218,229,447,0,10,55.25,8.1
"2011","Westergate BUA","E34004550","Total",9783,4729,5054,9619,164,156,550.50,17.8
"2011","Weston-Super-Mare BUA","E34004551","Total",84452,40992,43460,82614,1838,736,1929.50,43.8
"2011","Consett BUA","E34004552","Total",29137,14261,14876,28821,316,232,735.25,39.6
"2011","Selston/Brinsley BUA","E34004553","Total",17066,8390,8676,16919,147,97,544.25,31.4
"2011","Wisbech BUA","E34004554","Total",32489,15849,16640,32069,420,231,1247.50,26.0
"2011","Bicknacre BUA","E34004555","Total",2889,1419,1470,2871,18,55,127.75,22.6
"2011","Heage/Crich BUA","E34004556","Total",6629,3310,3319,6586,43,74,335.00,19.8
"2011","Blackburn BUA","E34004557","Total",146521,73064,73457,144800,1721,1423,3561.00,41.1
"2011","Catsfield BUA","E34004558","Total",639,310,329,595,44,7,45.75,14.0
"2011","Lower Weare BUA","E34004559","Total",325,168,157,325,0,7,48.75,6.7
"2011","Maidenhead BUA","E34004560","Total",64831,31850,32981,64278,553,1249,1853.76,35.0
"2011","Grantham BUA","E34004561","Total",43833,21238,22595,43370,463,548,1295.25,33.8
"2011","Broad Oak/Cackle Street BUA","E34004562","Total",1422,704,718,1368,54,25,120.75,11.8
"2011","Grain BUA","E34004563","Total",1648,808,840,1646,2,9,609.25,2.7
"2011","Great Horkesley BUA","E34004564","Total",2476,1223,1253,2418,58,49,123.00,20.1
"2011","Holme-on-Spalding-Moor BUA","E34004565","Total",2860,1383,1477,2823,37,29,118.25,24.2
"2011","Stonebroom BUA","E34004566","Total",5435,2631,2804,5377,58,39,185.25,29.3
"2011","Fen End BUA","E34004567","Total",193,102,91,193,0,4,50.75,3.8
"2011","Symonds Yat West/Whitchurch BUA","E34004568","Total",572,280,292,544,28,14,114.25,5.0
"2011","Tiptoe BUA","E34004569","Total",495,253,242,495,0,11,95.25,5.2
"2011","Southwold BUA","E34004570","Total",3680,1675,2005,3570,110,44,172.75,21.3
"2011","Burntwood BUA","E34004571","Total",29244,14537,14707,28963,281,267,739.75,39.5
"2011","Oxford BUA","E34004572","Total",171380,84923,86457,152362,19018,2831,3737.50,45.9
"2011","Ditton BUA","E34004573","Total",25982,12672,13310,25862,120,284,874.50,29.7
"2011","Itchen Abbas/Easton BUA","E34004574","Total",842,417,425,842,0,30,112.50,7.5
"2011","Winterbourne Gunner/Porton BUA","E34004575","Total",2612,1251,1361,2605,7,56,186.25,14.0
"2011","Moulsford/South Stoke BUA","E34004576","Total",1108,551,557,1032,76,42,68.75,16.1
"2011","Hartlebury BUA","E34004577","Total",1525,762,763,1525,0,32,145.50,10.5
"2011","Distington BUA","E34004578","Total",1445,694,751,1409,36,8,146.00,9.9
"2011","Wareham BUA","E34004579","Total",7592,3618,3974,7549,43,105,259.75,29.2
"2011","Burnham-on-Sea BUA","E34004580","Total",23325,11229,12096,22842,483,174,775.00,30.1
"2011","Nailsea BUA","E34004581","Total",20543,9945,10598,20436,107,438,737.75,27.8
"2011","Romsey BUA","E34004582","Total",17161,8113,9048,16932,229,293,524.25,32.7
"2011","Cherry Willingham BUA","E34004583","Total",3972,1918,2054,3927,45,51,141.25,28.1
"2011","Bugle BUA","E34004584","Total",2873,1455,1418,2871,2,18,118.00,24.3
"2011","Alfreton/South Normanton BUA","E34004585","Total",38460,19100,19360,38149,311,269,1378.75,27.9
"2011","Eccleston BUA","E34004586","Total",4646,2273,2373,4644,2,63,157.25,29.5
"2011","Stafford BUA","E34004587","Total",69217,35346,33871,66989,2228,854,2045.75,33.8
"2011","Mildenhall BUA","E34004588","Total",14382,7238,7144,14145,237,112,952.50,15.1
"2011","West Kirby/Hoylake BUA","E34004589","Total",25868,12313,13555,25428,440,569,854.00,30.3
"2011","Betley BUA","E34004590","Total",1033,510,523,1033,0,19,67.25,15.4
"2011","Uckfield BUA","E34004591","Total",18452,8909,9543,18183,269,334,719.75,25.6
"2011","Cromford BUA","E34004592","Total",2073,1032,1041,2048,25,38,107.50,19.3
"2011","Cambridge Batch/Flax Bourton BUA","E34004593","Total",715,352,363,708,7,18,52.00,13.8
"2011","Berkhamsted BUA","E34004594","Total",21997,10700,11297,21837,160,548,688.50,31.9
"2011","Billingborough BUA","E34004595","Total",1837,880,957,1820,17,22,87.00,21.1
"2011","Stroud BUA","E34004596","Total",60155,29574,30581,59368,787,997,2469.00,24.4
"2011","Windsor BUA","E34004597","Total",33348,16947,16401,31686,1662,555,808.50,41.2
"2011","Aslockton BUA","E34004598","Total",1571,773,798,1571,0,18,82.50,19.0
"2011","Billericay BUA","E34004599","Total",36338,17722,18616,36259,79,637,1024.50,35.5
"2011","Loggerheads BUA","E34004600","Total",3623,1808,1815,3623,0,75,191.25,18.9
"2011","Kirkham BUA","E34004601","Total",11915,5991,5924,11237,678,137,349.25,34.1
"2011","Great Yarmouth BUA","E34004602","Total",63434,31257,32177,62718,716,374,1536.00,41.3
"2011","Peaslake BUA","E34004603","Total",2731,1358,1373,2717,14,77,317.50,8.6
"2011","Tadley BUA","E34004604","Total",15836,7922,7914,15724,112,238,757.75,20.9
"2011","Horam BUA","E34004605","Total",2188,1015,1173,2123,65,28,203.00,10.8
"2011","Perranporth BUA","E34004606","Total",3210,1559,1651,3210,0,37,141.75,22.6
"2011","Boston Spa BUA","E34004607","Total",6052,2876,3176,6019,33,116,223.25,27.1
"2011","Midhurst BUA","E34004608","Total",6514,3025,3489,6450,64,107,220.00,29.6
"2011","Saltdean/Woodingdean BUA","E34004609","Total",22729,10873,11856,22478,251,224,586.50,38.8
"2011","Sacriston BUA","E34004610","Total",7030,3468,3562,7002,28,57,158.00,44.5
"2011","Northampton BUA","E34004611","Total",215963,106011,109952,212131,3832,2285,5788.00,37.3
"2011","Stoke-on-Trent BUA","E34004612","Total",372775,185070,187705,368804,3971,2709,10389.76,35.9
"2011","Eye (City of Peterborough) BUA","E34004613","Total",4340,2091,2249,4327,13,32,102.25,42.4
"2011","Yatton BUA","E34004614","Total",10251,4927,5324,10132,119,179,343.00,29.9
"2011","Wetheral BUA","E34004615","Total",1605,768,837,1601,4,43,84.25,19.1
"2011","Kidlington BUA","E34004616","Total",15829,7856,7973,15546,283,214,589.50,26.9
"2011","Weymouth BUA","E34004617","Total",57691,28248,29443,56847,844,641,1445.75,39.9
"2011","Duckmanton BUA","E34004618","Total",1702,826,876,1685,17,9,75.75,22.5
"2011","Minster (Swale) BUA","E34004619","Total",22167,10855,11312,22004,163,160,657.00,33.7
"2011","Friskney/Fold Hill BUA","E34004620","Total",632,306,326,632,0,2,50.25,12.6
"2011","Stoborough Green BUA","E34004621","Total",869,434,435,869,0,22,64.25,13.5
"2011","Telford BUA","E34004622","Total",147980,73196,74784,146939,1041,1416,4768.25,31.0
"2011","Gedney Hill BUA","E34004623","Total",1072,530,542,1072,0,5,66.75,16.1
"2011","Weston (Weymouth and Portland) BUA","E34004624","Total",8831,4543,4288,8393,438,73,208.25,42.4
"2011","Hastings BUA","E34004625","Total",133422,64017,69405,130557,2865,1164,3319.50,40.2
"2011","Wargrave BUA","E34004626","Total",4209,2032,2177,4122,87,157,246.75,17.1
"2011","Dullingham/Stetchworth BUA","E34004627","Total",1471,757,714,1460,11,36,76.25,19.3
"2011","Ellington/Lynemouth BUA","E34004628","Total",4284,2132,2152,4252,32,43,169.25,25.3
"2011","Ruardean BUA","E34004629","Total",1849,927,922,1849,0,19,85.25,21.7
"2011","Sunderland BUA","E34004630","Total",335415,162915,172500,331351,4064,2024,8348.00,40.2
"2011","Helford Passage BUA","E34004631","Total",197,94,103,192,5,4,78.25,2.5
"2011","Hutton Rudby BUA","E34004632","Total",1968,964,1004,1968,0,61,99.50,19.8
"2011","Nuneaton BUA","E34004633","Total",92698,45517,47181,92168,530,972,2300.00,40.3
"2011","Bignall End/Audley BUA","E34004634","Total",7609,3742,3867,7572,37,52,229.75,33.1
"2011","Oughtibridge BUA","E34004635","Total",4939,2440,2499,4919,20,67,151.50,32.6
"2011","Four Marks BUA","E34004636","Total",5674,2791,2883,5603,71,155,501.00,11.3
"2011","Yorkletts BUA","E34004637","Total",372,193,179,372,0,3,73.75,5.0
"2011","Derby BUA","E34004638","Total",270468,133674,136794,266172,4296,2832,6410.25,42.2
"2011","Carnon Downs BUA","E34004639","Total",2025,949,1076,2025,0,35,109.00,18.6
"2011","Reading BUA","E34004640","Total",318014,158279,159735,310602,7412,5337,8369.75,38.0
"2011","Bordon BUA","E34004641","Total",20978,10455,10523,20605,373,303,715.25,29.3
"2011","Hurley/Danesfield BUA","E34004642","Total",1339,672,667,1339,0,96,99.50,13.5
"2011","Felsted/Bannister Green BUA","E34004643","Total",2691,1340,1351,2382,309,78,130.75,20.6
"2011","Felixstowe BUA","E34004644","Total",29171,14073,15098,28700,471,372,1206.25,24.2
"2011","Basildon BUA","E34004645","Total",144859,70207,74652,143741,1118,1069,3712.25,39.0
"2011","Harrogate BUA","E34004646","Total",89060,43031,46029,87283,1777,1498,2290.50,38.9
"2011","Leicester BUA","E34004647","Total",508916,250367,258549,497086,11830,5867,10936.51,46.5
"2011","Pontefract BUA","E34004648","Total",44710,21829,22881,44369,341,374,1280.75,34.9
"2011","Wanborough BUA","E34004649","Total",2268,1153,1115,2136,132,52,105.50,21.5
"2011","Leeming BUA","E34004650","Total",3427,1960,1467,2720,707,39,308.25,11.1
"2011","Frating Green BUA","E34004651","Total",284,150,134,284,0,4,66.00,4.3
"2011","Edith Weston BUA","E34004652","Total",818,525,293,480,338,10,126.25,6.5
"2011","Swallowfield/Riseley BUA","E34004653","Total",1243,641,602,1243,0,43,63.25,19.7
"2011","Birkenhead BUA","E34004654","Total",325264,157220,168044,322106,3158,3026,8822.50,36.9
"2011","Bucklow Hill BUA","E34004655","Total",470,246,224,470,0,15,74.50,6.3
"2011","Cleehill BUA","E34004656","Total",916,444,472,916,0,2,52.75,17.4
"2011","Feock/Penpol BUA","E34004657","Total",1067,510,557,1067,0,28,146.25,7.3
"2011","Exton (East Devon) BUA","E34004658","Total",1790,1308,482,914,876,35,105.25,17.0
"2011","Horsham BUA","E34004659","Total",51472,25017,26455,50958,514,855,1260.75,40.8
"2011","Macclesfield BUA","E34004660","Total",63954,31266,32688,63312,642,1070,2068.00,30.9
"2011","Combe St Nicholas BUA","E34004661","Total",1029,488,541,1027,2,12,68.00,15.1
"2011","Saxmundham BUA","E34004662","Total",4225,2013,2212,4185,40,38,143.00,29.5
"2011","New Arley BUA","E34004663","Total",2409,1198,1211,2409,0,16,77.25,31.2
"2011","Folkestone BUA","E34004664","Total",66429,32746,33683,65137,1292,562,1675.50,39.6
"2011","Cross Hills BUA","E34004665","Total",11731,5544,6187,11327,404,163,340.25,34.5
"2011","Addington BUA","E34004666","Total",857,423,434,857,0,11,74.50,11.5
"2011","Claydon BUA","E34004667","Total",4488,2220,2268,4441,47,50,173.75,25.8
"2011","Andover BUA","E34004668","Total",42276,20662,21614,41694,582,483,1185.50,35.7
"2011","Swanley BUA","E34004669","Total",21839,10554,11285,21836,3,234,511.25,42.7
"2011","Thurnscoe/Bolton Upon Dearne BUA","E34004670","Total",21482,10498,10984,21344,138,97,512.25,41.9
"2011","Worksop BUA","E34004671","Total",43252,21175,22077,42608,644,401,1222.00,35.4
"2011","North Walney BUA","E34004672","Total",9952,4829,5123,9893,59,78,284.50,35.0
"2011","Marlow BUA","E34004673","Total",18261,8846,9415,18141,120,389,564.75,32.3
"2011","Redhill (Reigate and Banstead) BUA","E34004674","Total",56621,27707,28914,55779,842,807,1570.00,36.1
"2011","Castleford BUA","E34004675","Total",60509,29709,30800,59996,513,447,1715.00,35.3
"2011","Whitley (Wiltshire) BUA","E34004676","Total",2436,1168,1268,2386,50,32,115.50,21.1
"2011","Great Chishill BUA","E34004677","Total",921,457,464,921,0,32,58.50,15.7
"2011","West Wellow BUA","E34004678","Total",2929,1404,1525,2888,41,68,258.50,11.3
"2011","Tollerton (Rushcliffe) BUA","E34004679","Total",1544,781,763,1544,0,21,234.00,6.6
"2011","Mountsorrel BUA","E34004680","Total",17297,8462,8835,17148,149,295,557.25,31.0
"2011","Brinscall BUA","E34004681","Total",2286,1124,1162,2286,0,56,62.75,36.4
"2011","Stevenage BUA","E34004682","Total",90232,44702,45530,89680,552,952,2189.50,41.2
"2011","Northill/Ickwell BUA","E34004683","Total",636,314,322,636,0,13,48.50,13.1
"2011","West Yorkshire BUA","E34004684","Total",1777934,874809,903125,1746406,31528,16164,48778.51,36.4
"2011","Droitwich BUA","E34004685","Total",23834,11503,12331,23619,215,322,686.75,34.7
"2011","Lancaster/Morecambe BUA","E34004686","Total",97150,46716,50434,94576,2574,1100,2259.00,43.0
"2011","Littlewick Green BUA","E34004687","Total",234,113,121,234,0,6,48.75,4.8
"2011","Knowl Hill BUA","E34004688","Total",910,456,454,859,51,23,126.75,7.2
"2011","St Day BUA","E34004689","Total",3430,1648,1782,3428,2,22,138.75,24.7
"2011","Desford BUA","E34004690","Total",3179,1557,1622,3178,1,48,125.25,25.4
"2011","Burringham BUA","E34004691","Total",1179,600,579,1139,40,11,48.00,24.6
"2011","Great Abington/Little Abington BUA","E34004692","Total",1155,560,595,1155,0,30,88.00,13.1
"2011","Gloucester BUA","E34004693","Total",150053,73993,76060,147871,2182,1719,4035.76,37.2
"2011","Compton/Otterbourne BUA","E34004694","Total",2569,1240,1329,2489,80,90,183.25,14.0
"2011","Wells BUA","E34004695","Total",11343,5259,6084,10927,416,203,350.25,32.4
"2011","Doncaster BUA","E34004696","Total",158141,77928,80213,156252,1889,1596,4352.25,36.3
"2011","Lane End BUA","E34004697","Total",3200,1573,1627,3195,5,54,120.00,26.7
"2011","Fiskerton (Newark and Sherwood) BUA","E34004698","Total",902,448,454,902,0,21,55.00,16.4
"2011","Newchapel BUA","E34004699","Total",253,124,129,253,0,6,42.75,5.9
"2011","Burley BUA","E34004700","Total",1384,642,742,1324,60,29,177.25,7.8
"2011","Farley Green BUA","E34004701","Total",321,143,178,319,2,10,54.00,5.9
"2011","Boxted BUA","E34004702","Total",1004,488,516,1004,0,24,71.75,14.0
"2011","Glapwell BUA","E34004703","Total",2202,1069,1133,2202,0,18,87.75,25.1
"2011","High Wycombe BUA","E34004704","Total",133204,65802,67402,130797,2407,2384,3920.26,34.0
"2011","Swaffham Bulbeck BUA","E34004705","Total",708,335,373,707,1,16,46.50,15.2
"2011","Stourport-on-Severn BUA","E34004706","Total",20586,10053,10533,20473,113,168,603.25,34.1
"2011","Greater London BUA","E34004707","Total",9787426,4824174,4963252,9663206,124220,124871,173785.50,56.3
"2011","Birchanger BUA","E34004708","Total",596,291,305,596,0,6,663.00,0.9
"2011","Botloe's Green BUA","E34004709","Total",354,177,177,322,32,9,70.00,5.1
"2011","Pershore BUA","E34004710","Total",7626,3710,3916,7562,64,81,271.00,28.1
"2011","Dursley BUA","E34004711","Total",14992,7411,7581,14900,92,202,443.50,33.8
"2011","Copmanthorpe BUA","E34004712","Total",3674,1795,1879,3674,0,92,117.75,31.2
"2011","Ushaw Moor BUA","E34004713","Total",7368,3583,3785,7301,67,67,165.00,44.7
"2011","Yate BUA","E34004714","Total",34406,16947,17459,34078,328,317,945.75,36.4
"2011","Peterborough BUA","E34004715","Total",163379,80741,82638,162098,1281,1694,4423.50,36.9
"2011","Sharlston BUA","E34004716","Total",4028,1949,2079,3965,63,23,94.25,42.7
"2011","Ightham BUA","E34004717","Total",6638,3239,3399,6592,46,147,391.00,17.0
"2011","Charlton Adam BUA","E34004718","Total",1073,527,546,1073,0,23,64.00,16.8
"2011","Sturry BUA","E34004719","Total",7386,3578,3808,7249,137,79,255.25,28.9
"2011","Rugby BUA","E34004720","Total",73150,36400,36750,71883,1267,948,1912.50,38.2
"2011","Lingfield BUA","E34004721","Total",3920,1828,2092,3861,59,53,149.00,26.3
"2011","Parbold BUA","E34004722","Total",3904,1869,2035,3827,77,74,200.50,19.5
"2011","Goosnargh BUA","E34004723","Total",1398,674,724,1367,31,21,72.75,19.2
"2011","Tutbury/Hatton BUA","E34004724","Total",5639,2778,2861,5638,1,49,163.75,34.4
"2011","Peterlee BUA","E34004725","Total",37015,17960,19055,36687,328,224,1148.50,32.2
"2011","Eversley Centre/Eversley Cross BUA","E34004726","Total",1265,619,646,1260,5,20,48.75,25.9
"2011","Keevil BUA","E34004727","Total",441,213,228,441,0,9,93.50,4.7
"2011","Wheelton/Great Knowley BUA","E34004728","Total",1812,863,949,1812,0,34,62.50,29.0
"2011","Fordingbridge BUA","E34004729","Total",6066,2924,3142,5901,165,108,245.75,24.7
"2011","Ipswich BUA","E34004730","Total",178835,88482,90353,176357,2478,2069,4914.25,36.4
"2011","Broadmayne/West Knighton BUA","E34004731","Total",1579,758,821,1563,16,36,65.25,24.2
"2011","East Hendred BUA","E34004732","Total",1502,747,755,1502,0,57,90.75,16.6
"2011","Eye (Mid Suffolk) BUA","E34004733","Total",2742,1329,1413,2688,54,31,177.25,15.5
"2011","Haslemere BUA","E34004734","Total",13651,6569,7082,13460,191,346,738.25,18.5
"2011","Chelwood Gate BUA","E34004735","Total",952,460,492,911,41,32,102.00,9.3
"2011","Mundford BUA","E34004736","Total",1835,899,936,1810,25,24,92.75,19.8
"2011","Hatfield Peverel BUA","E34004737","Total",3950,1933,2017,3902,48,63,138.00,28.6
"2011","Chalfont St Giles BUA","E34004738","Total",7957,3835,4122,7957,0,267,372.50,21.4
"2011","Fradley South BUA","E34004739","Total",2818,1387,1431,2818,0,54,190.75,14.8
"2011","Caldecote BUA","E34004740","Total",1737,882,855,1737,0,34,131.50,13.2
"2011","Tickton BUA","E34004741","Total",1731,865,866,1731,0,36,62.25,27.8
"2011","Thorne BUA","E34004742","Total",17295,8398,8897,17143,152,140,478.25,36.2
"2011","Burnley BUA","E34004743","Total",149422,73364,76058,148017,1405,1448,3572.25,41.8
"2011","Hartley BUA","E34004744","Total",16302,7847,8455,16088,214,279,689.75,23.6
"2011","Alsager BUA","E34004745","Total",13347,6473,6874,13187,160,237,473.50,28.2
"2011","Wormley BUA","E34004746","Total",1770,886,884,1436,334,91,169.00,10.5
"2011","West Itchenor BUA","E34004747","Total",289,142,147,289,0,17,100.25,2.9
"2011","Brighton and Hove BUA","E34004748","Total",474485,232595,241890,467584,6901,4542,8944.75,53.0
"2011","Snaith BUA","E34004749","Total",3305,1598,1707,3254,51,51,99.50,33.2
"2011","Maltby BUA","E34004750","Total",17513,8604,8909,17360,153,132,479.25,36.5
"2011","Yapton BUA","E34004751","Total",5459,2810,2649,5009,450,62,199.00,27.4
"2011","Stoke Ferry BUA","E34004752","Total",1389,660,729,1389,0,20,94.50,14.7
"2011","Brundall BUA","E34004753","Total",5927,2838,3089,5806,121,85,252.50,23.5
"2011","Puriton BUA","E34004754","Total",1968,945,1023,1964,4,26,88.50,22.2
"2011","Dedham BUA","E34004755","Total",1014,506,508,1013,1,19,92.25,11.0
"2011","Northwich BUA","E34004756","Total",47421,23388,24033,47051,370,620,1441.00,32.9
"2011","Truro BUA","E34004757","Total",23041,10936,12105,22908,133,359,733.00,31.4
"2011","Didcot BUA","E34004758","Total",29341,14498,14843,29182,159,398,1074.75,27.3
"2011","Sutton Lane Ends BUA","E34004759","Total",1565,766,799,1565,0,33,62.50,25.0
"2011","Higham on the Hill BUA","E34004760","Total",840,442,398,720,120,9,186.50,4.5
"2011","Cromer BUA","E34004761","Total",8801,4181,4620,8541,260,80,323.50,27.2
"2011","Crewe BUA","E34004762","Total",75556,37427,38129,75140,416,634,2007.00,37.6
"2011","East Wittering BUA","E34004763","Total",5647,2667,2980,5563,84,55,215.75,26.2
"2011","Sutton Valence/Langley Heath BUA","E34004764","Total",2309,1144,1165,2155,154,34,142.50,16.2
"2011","Mansfield BUA","E34004765","Total",171958,84452,87506,170315,1643,1346,4835.49,35.6
"2011","Leiston BUA","E34004766","Total",6495,3149,3346,6376,119,74,250.25,26.0
"2011","Diss BUA","E34004767","Total",10734,5187,5547,10595,139,98,381.25,28.2
"2011","St Neots BUA","E34004768","Total",30811,15384,15427,30563,248,335,812.25,37.9
"2011","St Ives (Huntingdonshire) BUA","E34004769","Total",19519,9626,9893,19478,41,307,545.00,35.8
"2011","Windermere BUA","E34004770","Total",7765,3769,3996,7369,396,144,386.00,20.1
"2011","Shrivenham/Watchfield BUA","E34004771","Total",4049,2057,1992,3919,130,179,212.00,19.1
"2011","Coppull BUA","E34004772","Total",9014,4442,4572,8901,113,73,234.75,38.4
"2011","Offenham/South Littleton BUA","E34004773","Total",3154,1504,1650,3141,13,44,250.75,12.6
"2011","Upper Hartfield BUA","E34004774","Total",985,485,500,985,0,19,117.25,8.4
"2011","Callington BUA","E34004775","Total",5786,2866,2920,5786,0,56,183.25,31.6
"2011","Newbury/Thatcham BUA","E34004776","Total",68258,33711,34547,67191,1067,1076,1984.00,34.4
"2011","Dunscroft BUA","E34004777","Total",20608,10025,10583,20386,222,141,544.25,37.9
"2011","Weston Rhyn BUA","E34004778","Total",2502,1131,1371,2287,215,26,93.00,26.9
"2011","Pickering BUA","E34004779","Total",6936,3222,3714,6850,86,97,274.75,25.2
"2011","Shefford BUA","E34004780","Total",10816,5323,5493,10744,72,157,305.25,35.4
"2011","Stake Pool/Pilling BUA","E34004781","Total",1483,750,733,1458,25,20,99.00,15.0
"2011","Yalding BUA","E34004782","Total",1365,656,709,1365,0,22,79.50,17.2
"2011","Hitchin BUA","E34004783","Total",36099,17760,18339,35756,343,606,919.75,39.2
"2011","Kiveton Park BUA","E34004784","Total",8703,4245,4458,8702,1,90,253.00,34.4
"2011","Bridgnorth BUA","E34004785","Total",12657,6215,6442,12522,135,203,367.75,34.4
"2011","Winchelsea Beach BUA","E34004786","Total",1362,647,715,1359,3,12,100.00,13.6
"2011","Corsham BUA","E34004787","Total",14906,7180,7726,14732,174,287,557.50,26.7
"2011","Corby BUA","E34004788","Total",56810,27972,28838,56585,225,491,2051.00,27.7
"2011","Rocester/Denstone BUA","E34004789","Total",2920,1462,1458,2707,213,53,104.75,27.9
"2011","Kilburn BUA","E34004790","Total",5552,2692,2860,5510,42,63,156.25,35.5
"2011","Kippax BUA","E34004791","Total",15965,7771,8194,15886,79,129,354.00,45.1
"2011","Headley (Mole Valley) BUA","E34004792","Total",774,399,375,768,6,33,112.50,6.9
"2011","Great Eccleston BUA","E34004793","Total",1657,788,869,1644,13,34,55.75,29.7
"2011","Sandy BUA","E34004794","Total",11657,5823,5834,11584,73,116,322.25,36.2
"2011","Wellington (Taunton Deane) BUA","E34004795","Total",13822,6647,7175,13518,304,183,360.00,38.4
"2011","Braintree BUA","E34004796","Total",53477,26115,27362,52827,650,515,1311.25,40.8
"2011","Penzance BUA","E34004797","Total",19872,9399,10473,19436,436,200,462.50,43.0
"2011","Cambridge BUA","E34004798","Total",158434,80059,78375,141085,17349,2655,4214.00,37.6
"2011","Churchill (North Somerset) BUA","E34004799","Total",1378,681,697,1368,10,23,106.75,12.9
"2011","Cranleigh BUA","E34004800","Total",11082,5442,5640,10498,584,264,444.75,24.9
"2011","Liverpool BUA","E34004801","Total",864122,422992,441130,844549,19573,6412,19960.51,43.3
"2011","Teesside BUA","E34004802","Total",376663,184059,192604,370751,5912,3058,10818.74,34.8
"2011","Hatfield BUA","E34004803","Total",41677,21158,20519,38653,3024,447,914.00,45.6
"2011","Bridlington BUA","E34004804","Total",35154,16940,18214,34216,938,275,868.25,40.5
"2011","Betchworth BUA","E34004805","Total",941,457,484,857,84,29,79.00,11.9
"2011","Sandown/Shanklin BUA","E34004806","Total",21374,10287,11087,20622,752,220,604.75,35.3
"2011","East Hanney BUA","E34004807","Total",1238,605,633,1238,0,37,82.75,15.0
"2011","Westonzoyland BUA","E34004808","Total",1686,830,856,1686,0,17,111.25,15.2
"2011","Dorking BUA","E34004809","Total",17747,8584,9163,17439,308,371,562.25,31.6
"2011","Kibworth Harcourt BUA","E34004810","Total",5790,2767,3023,5720,70,103,177.50,32.6
"2011","Leek BUA","E34004811","Total",19903,9664,10239,19605,298,220,509.25,39.1
"2011","Bawtry BUA","E34004812","Total",4109,2002,2107,4100,9,79,151.50,27.1
"2011","Paignton/Torquay BUA","E34004813","Total",115410,55683,59727,112577,2833,1159,3147.25,36.7
"2011","Heathfield (Wealden) BUA","E34004814","Total",8457,4070,4387,8331,126,133,408.75,20.7
"2011","Walton-on-the-Naze BUA","E34004815","Total",17458,7971,9487,17127,331,200,629.25,27.7
"2011","South Ferriby BUA","E34004816","Total",651,311,340,648,3,10,53.25,12.2
"2011","Partridge Green BUA","E34004817","Total",2341,1157,1184,2341,0,55,84.25,27.8
"2011","St Eval BUA","E34004818","Total",472,217,255,472,0,0,88.50,5.3
"2011","Iver Heath BUA","E34004819","Total",8065,3975,4090,8018,47,124,379.50,21.3
"2011","Marlborough BUA","E34004820","Total",8395,4039,4356,7561,834,178,268.25,31.3
"2011","Welwyn Garden City BUA","E34004821","Total",59910,28934,30976,59463,447,900,1887.75,31.7
"2011","Garstang BUA","E34004822","Total",9530,4584,4946,9439,91,132,321.00,29.7
"2011","Newton Abbot BUA","E34004823","Total",36474,17684,18790,36039,435,424,990.75,36.8
"2011","Shevington Vale/Shevington BUA","E34004824","Total",10311,5106,5205,10277,34,125,279.25,36.9
"2011","Watton BUA","E34004825","Total",9924,4855,5069,9789,135,77,414.25,24.0
"2011","Felton (North Somerset) BUA","E34004826","Total",779,383,396,779,0,6,228.00,3.4
"2011","Thrapston BUA","E34004827","Total",7068,3515,3553,7039,29,95,207.75,34.0
"2011","Swindon BUA","E34004828","Total",185609,93150,92459,184653,956,1711,4705.50,39.4
"2011","St Blazey BUA","E34004829","Total",9958,4771,5187,9668,290,72,392.25,25.4
"2011","Boroughbridge BUA","E34004830","Total",4163,2016,2147,4067,96,67,172.00,24.2
"2011","Sonning Common BUA","E34004831","Total",4821,2281,2540,4799,22,125,228.50,21.1
"2011","West Kingsdown BUA","E34004832","Total",5484,2686,2798,5451,33,55,290.25,18.9
"2011","Willaston BUA","E34004833","Total",2813,1368,1445,2804,9,75,166.25,16.9
"2011","Helston BUA","E34004834","Total",12184,6159,6025,11411,773,155,509.75,23.9
"2011","Harefield BUA","E34004835","Total",6573,3181,3392,6390,183,53,167.00,39.4
"2011","Bury St Edmunds BUA","E34004836","Total",42812,20998,21814,42279,533,612,1351.25,31.7
"2011","Hedon BUA","E34004837","Total",10358,4976,5382,10195,163,117,264.25,39.2
"2011","Stakeford BUA","E34004838","Total",9636,4623,5013,9542,94,66,205.50,46.9
"2011","Kingston upon Hull BUA","E34004839","Total",314018,156207,157811,308351,5667,2260,8258.26,38.0
"2011","Kidderminster BUA","E34004840","Total",57059,28102,28957,56520,539,539,1688.50,33.8
"2011","Royal Leamington Spa BUA","E34004841","Total",95172,47746,47426,93941,1231,1246,2237.75,42.5
"2011","Everton BUA","E34004842","Total",523,265,258,517,6,11,40.75,12.8
"2011","Runcorn BUA","E34004843","Total",62872,30728,32144,62503,369,473,2034.00,30.9
"2011","Minster (Thanet) BUA","E34004844","Total",3668,1782,1886,3654,14,42,128.50,28.5
"2011","Clay Cross/North Wingfield BUA","E34004845","Total",28665,14165,14500,28425,240,212,956.50,30.0
"2011","Thanet BUA","E34004846","Total",125370,60281,65089,123026,2344,1145,2789.25,44.9
"2011","Immingham BUA","E34004847","Total",10750,5254,5496,10662,88,67,1571.00,6.8
"2011","Seaton Delaval BUA","E34004848","Total",9350,4562,4788,9306,44,38,217.50,43.0
"2011","Goring BUA","E34004849","Total",4079,1941,2138,3975,104,127,239.00,17.1
"2011","Carnforth BUA","E34004850","Total",7920,3815,4105,7815,105,83,233.00,34.0
"2011","Lyneham Airfield BUA","E34004851","Total",4767,2535,2232,4238,529,78,335.50,14.2
"2011","Bardsey BUA","E34004852","Total",2876,1402,1474,2876,0,96,141.50,20.3
"2011","Woldingham BUA","E34004853","Total",1502,718,784,1502,0,56,250.50,6.0
"2011","South Harting BUA","E34004854","Total",1087,522,565,1087,0,54,63.50,17.1
"2011","Coventry BUA","E34004855","Total",359262,178375,180887,348069,11193,3795,8128.99,44.2
"2011","Rushden BUA","E34004856","Total",37584,18537,19047,37207,377,337,919.00,40.9
"2011","Goole BUA","E34004857","Total",20810,10189,10621,20512,298,136,608.25,34.2
"2011","Exeter BUA","E34004858","Total",117763,57195,60568,111798,5965,1308,2849.25,41.3
"2011","Hertford/Ware BUA","E34004859","Total",45457,22299,23158,45143,314,781,1018.50,44.6
"2011","Anna Valley BUA","E34004860","Total",2893,1406,1487,2791,102,99,129.00,22.4
"2011","Odiham BUA","E34004861","Total",3165,1496,1669,3159,6,69,131.75,24.0
"2011","Eastbourne BUA","E34004862","Total",118219,56490,61729,115589,2630,1087,2512.51,47.1
"2011","Highleigh/Street End BUA","E34004863","Total",637,333,304,622,15,23,207.25,3.1
"2011","Hemingbrough BUA","E34004864","Total",2483,1230,1253,2483,0,23,109.75,22.6
"2011","Stowmarket BUA","E34004865","Total",21028,10259,10769,20853,175,214,613.00,34.3
"2011","Penistone BUA","E34004866","Total",10956,5435,5521,10951,5,156,340.25,32.2
"2011","Wootton (Bedford) BUA","E34004867","Total",4344,2144,2200,4344,0,72,122.00,35.6
"2011","Charing Heath BUA","E34004868","Total",606,292,314,606,0,11,54.00,11.2
"2011","Barnsley/Dearne Valley BUA","E34004869","Total",223281,109684,113597,221476,1805,1535,5972.25,37.4
"2011","Canterbury BUA","E34004870","Total",55240,26748,28492,48301,6939,872,1319.75,41.9
"2011","Finstock BUA","E34004871","Total",1139,572,567,1139,0,22,66.50,17.1
"2011","Dormansland BUA","E34004872","Total",2550,1260,1290,2216,334,42,135.00,18.9
"2011","Winford (Isle of Wight) BUA","E34004873","Total",1610,798,812,1610,0,17,71.00,22.7
"2011","Stoke sub Hamdon BUA","E34004874","Total",2415,1180,1235,2415,0,43,93.25,25.9
"2011","Earlswood BUA","E34004875","Total",961,480,481,961,0,15,80.00,12.0
"2011","Cranbrook BUA","E34004876","Total",4368,2094,2274,4094,274,114,149.00,29.3
"2011","Wendover BUA","E34004877","Total",7702,3683,4019,7414,288,148,267.00,28.8
"2011","Teignmouth BUA","E34004878","Total",17463,8320,9143,16906,557,223,489.75,35.7
"2011","Launceston BUA","E34004879","Total",8910,4297,4613,8674,236,95,314.75,28.3
"2011","Crawley BUA","E34004880","Total",180508,88998,91510,178834,1674,2258,5809.00,31.1
"2011","Baker's Wood BUA","E34004881","Total",1322,652,670,1322,0,31,87.75,15.1
"2011","Cullompton BUA","E34004882","Total",7800,3794,4006,7679,121,70,226.75,34.4
"2011","Great Gransden BUA","E34004883","Total",1319,663,656,1318,1,41,91.75,14.4
"2011","Buckfastleigh BUA","E34004884","Total",3631,1772,1859,3570,61,38,133.50,27.2
"2011","Farnborough/Aldershot BUA","E34004885","Total",252397,124721,127676,249108,3289,3825,7846.50,32.2
"2011","Stanford Dingley BUA","E34004886","Total",457,227,230,457,0,30,50.50,9.0
"2011","Welton (West Lindsey) BUA","E34004887","Total",6381,3036,3345,6360,21,130,194.50,32.8
"2011","Little Clacton BUA","E34004888","Total",4590,2247,2343,4526,64,33,253.00,18.1
"2011","Kelsall BUA","E34004889","Total",2721,1311,1410,2691,30,64,132.25,20.6
"2011","Wellingborough BUA","E34004890","Total",50577,24713,25864,50212,365,553,1399.00,36.2
"2011","New Mills BUA","E34004891","Total",17968,8839,9129,17788,180,246,585.25,30.7
"2011","Amersham/Chesham BUA","E34004892","Total",46122,22571,23551,45849,273,1012,1551.00,29.7
"2011","Norwich BUA","E34004893","Total",213166,104611,108555,207523,5643,2178,6190.26,34.4
"2011","Stamford BUA","E34004894","Total",20592,9810,10782,20242,350,354,553.25,37.2
"2011","Chichester BUA","E34004895","Total",31654,14921,16733,30798,856,464,1106.00,28.6
"2011","South Elmsall/South Kirkby BUA","E34004896","Total",18899,9317,9582,18765,134,117,567.75,33.3
"2011","East Goscote BUA","E34004897","Total",3963,1911,2052,3874,89,68,113.00,35.1
"2011","Wood End (Stratford-on-Avon) BUA","E34004898","Total",942,461,481,942,0,33,100.00,9.4
"2011","Ringwood BUA","E34004899","Total",14084,6738,7346,13915,169,196,611.50,23.0
"2011","Blackpool BUA","E34004900","Total",239409,116495,122914,233967,5442,2509,6126.50,39.1
"2011","Finchampstead BUA","E34004901","Total",1034,514,520,1029,5,46,122.50,8.4
"2011","Lingwood BUA","E34004902","Total",2719,1323,1396,2717,2,30,108.00,25.2
"2011","Clutton/Temple Cloud BUA","E34004903","Total",2741,1376,1365,2694,47,46,107.25,25.6
"2011","Lympne BUA","E34004904","Total",1704,840,864,1680,24,47,61.25,27.8
"2011","Accrington/Rossendale BUA","E34004905","Total",125059,61590,63469,123801,1258,1233,3000.50,41.7
"2011","Winchester BUA","E34004906","Total",46074,22198,23876,42451,3623,1107,1232.75,37.4
"2011","Grayshott BUA","E34004907","Total",7641,3715,3926,7249,392,191,457.50,16.7
"2011","Ashford (Ashford) BUA","E34004908","Total",74733,36444,38289,74153,580,711,1905.00,39.2
"2011","Hartlepool BUA","E34004909","Total",88855,43240,45615,87992,863,733,2412.25,36.8
"2011","Coleford (Forest of Dean) BUA","E34004910","Total",10397,5084,5313,10338,59,109,418.25,24.9
"2011","Bishop Auckland BUA","E34004911","Total",26050,12399,13651,25687,363,241,731.00,35.6
"2011","Speldhurst BUA","E34004912","Total",1436,700,736,1414,22,49,100.25,14.3
"2011","Falmouth BUA","E34004913","Total",31988,15377,16611,30833,1155,329,854.75,37.4
"2011","Sileby/Barrow upon Soar BUA","E34004914","Total",14389,7030,7359,14222,167,195,386.75,37.2
"2011","Cramlington BUA","E34004915","Total",33180,15969,17211,32851,329,254,877.50,37.8
"2011","Sibford Gower/Sibford Ferris BUA","E34004916","Total",984,493,491,923,61,50,58.00,17.0
"2011","Grimsby BUA","E34004917","Total",134160,65804,68356,132691,1469,1065,3526.50,38.0
"2011","Bovingdon BUA","E34004918","Total",5295,2937,2358,4545,750,72,224.00,23.6
"2011","Carterton BUA","E34004919","Total",16364,8484,7880,15110,1254,236,723.75,22.6
"2011","Woolsington BUA","E34004920","Total",293,141,152,293,0,3,271.25,1.1
"2011","Steyning BUA","E34004921","Total",9627,4530,5097,9474,153,177,295.00,32.6
"2011","Abingdon BUA","E34004922","Total",38676,19193,19483,37661,1015,675,1062.00,36.4
"2011","Bembridge BUA","E34004923","Total",3688,1696,1992,3472,216,59,276.75,13.3
"2011","Chelmsford BUA","E34004924","Total",111511,54939,56572,110173,1338,1594,2618.00,42.6
"2011","Keadby BUA","E34004925","Total",2238,1117,1121,2238,0,12,138.25,16.2
"2011","Shorne Ridgeway BUA","E34004926","Total",3656,1768,1888,3639,17,54,168.00,21.8
"2011","Eastchurch BUA","E34004927","Total",1135,557,578,1125,10,5,85.50,13.3
"2011","Soham BUA","E34004928","Total",9834,4898,4936,9803,31,95,269.75,36.5
"2011","Coleorton/Griffydam BUA","E34004929","Total",679,324,355,679,0,14,112.50,6.0
"2011","St Merryn Holiday Village BUA","E34004930","Total",312,148,164,312,0,3,82.00,3.8
"2011","Upham/Lower Upham BUA","E34004931","Total",663,345,318,658,5,35,58.00,11.4
"2011","Rudgwick BUA","E34004932","Total",1955,936,1019,1955,0,67,135.75,14.4
"2011","Goldsithney BUA","E34004933","Total",1994,909,1085,1911,83,30,107.25,18.6
"2011","Morgan's Vale BUA","E34004934","Total",3040,1455,1585,2965,75,73,175.75,17.3
"2011","Burscough BUA","E34004935","Total",8799,4328,4471,8690,109,93,307.00,28.7
"2011","West Walton BUA","E34004936","Total",1731,884,847,1731,0,25,95.50,18.1
"2011","Waltham Chase BUA","E34004937","Total",3942,1940,2002,3879,63,95,228.25,17.3
"2011","Towngate BUA","E34004938","Total",1424,704,720,1424,0,22,98.50,14.5
"2011","Cannock BUA","E34004939","Total",86121,42577,43544,85542,579,679,2193.00,39.3
"2011","Slough BUA","E34004940","Total",163777,81467,82310,163015,762,1940,3414.25,48.0
"2011","Worcester BUA","E34004941","Total",101659,49957,51702,99689,1970,1138,2466.75,41.2
"2011","Westfield (County of Herefordshire) BUA","E34004942","Total",1052,524,528,1052,0,23,57.00,18.5
"2011","Godalming BUA","E34004943","Total",22689,11293,11396,21556,1133,507,723.00,31.4
"2011","Brough (East Riding of Yorkshire) BUA","E34004944","Total",19904,9745,10159,19763,141,369,784.50,25.4
"2011","Stanley (County Durham) BUA","E34004945","Total",21938,10730,11208,21685,253,111,537.75,40.8
"2011","Nottingham BUA","E34004946","Total",729977,362184,367793,710412,19565,6967,17636.25,41.4
"2011","Whitehaven BUA","E34004947","Total",24900,12386,12514,24617,283,251,723.25,34.4
"2011","Newark-on-Trent BUA","E34004948","Total",43363,21203,22160,43009,354,416,1310.50,33.1
"2011","Yarmouth BUA","E34004949","Total",912,431,481,911,1,12,57.50,15.9
"2011","Earl Shilton BUA","E34004950","Total",19578,9642,9936,19388,190,134,476.00,41.1
"2011","Stanbridge BUA","E34004951","Total",1044,516,528,1019,25,12,76.00,13.7
"2011","Gunnislake BUA","E34004952","Total",4044,1960,2084,4044,0,67,235.75,17.2
"2011","Lymington BUA","E34004953","Total",16446,7697,8749,16189,257,239,670.50,24.5
"2011","Aylesbury BUA","E34004954","Total",74748,37136,37612,73728,1020,852,1648.25,45.3
"2011","South Petherton BUA","E34004955","Total",3064,1439,1625,3031,33,45,132.50,23.1
"2011","St Austell BUA","E34004956","Total",25447,12228,13219,24804,643,248,781.50,32.6
"2011","Cinderford BUA","E34004957","Total",12942,6390,6552,12856,86,82,473.25,27.3
"2011","Colyton BUA","E34004958","Total",2668,1251,1417,2627,41,50,123.75,21.6
"2011","Wigan BUA","E34004959","Total",175405,86824,88581,174234,1171,1387,4375.25,40.1
"2011","Norton-on-Derwent/Malton BUA","E34004960","Total",11937,5835,6102,11731,206,137,420.00,28.4
"2011","Bidford-on-Avon BUA","E34004961","Total",5047,2456,2591,4970,77,61,147.50,34.2
"2011","Dunswell/Thearne BUA","E34004962","Total",962,480,482,962,0,6,131.00,7.3
"2011","Royal Tunbridge Wells BUA","E34004963","Total",68910,33924,34986,68078,832,1318,1689.51,40.8
"2011","Braunton BUA","E34004964","Total",9525,4830,4695,8947,578,150,405.75,23.5
"2011","Bristol BUA","E34004965","Total",617280,306875,310405,604716,12564,5789,14442.50,42.7
"2011","Prudhoe BUA","E34004966","Total",12075,5822,6253,11980,95,129,346.25,34.9
"2011","Kettering BUA","E34004967","Total",63675,31356,32319,62969,706,757,1648.75,38.6
"2011","Town Row BUA","E34004968","Total",1842,887,955,1842,0,59,148.00,12.4
"2011","Sheffield BUA","E34004969","Total",685368,337875,347493,670737,14631,6027,16747.76,40.9
"2011","Burton upon Trent BUA","E34004970","Total",122199,60444,61755,121357,842,1081,3504.00,34.9
"2011","Wivelsfield Green BUA","E34004971","Total",1091,529,562,1079,12,17,57.00,19.1
"2011","Meare Green/Stoke St Gregory BUA","E34004972","Total",626,305,321,626,0,14,63.75,9.8
"2011","Wivenhoe BUA","E34004973","Total",9567,4669,4898,9559,8,97,215.75,44.3
"2011","Leysdown-on-Sea BUA","E34004974","Total",3019,1515,1504,2971,48,13,163.75,18.4
"2011","Whalley BUA","E34004975","Total",4754,2333,2421,4546,208,88,154.50,30.8
"2011","Frogham BUA","E34004976","Total",928,447,481,928,0,26,85.25,10.9
"2011","South Hampshire BUA","E34004977","Total",855569,425521,430048,838640,16929,8009,19203.25,44.6
"2011","Grays BUA","E34004978","Total",89755,44468,45287,89294,461,719,2635.25,34.1
"2011","Lesbury BUA","E34004979","Total",1007,482,525,1007,0,21,59.00,17.1
"2011","Bishop's Cleeve BUA","E34004980","Total",14231,6774,7457,14123,108,248,443.50,32.1
"2011","Chipping Campden BUA","E34004981","Total",2288,1075,1213,2226,62,39,136.25,16.8
"2011","Banbury BUA","E34004982","Total",48651,23817,24834,48330,321,482,1204.50,40.4
"2011","Luton BUA","E34004983","Total",258018,128864,129154,256024,1994,2833,5071.25,50.9
"2011","Elsenham BUA","E34004984","Total",2272,1123,1149,2268,4,39,96.75,23.5
"2011","Chesterfield BUA","E34004985","Total",113057,55414,57643,111939,1118,1255,3464.50,32.6
"2011","Atherstone BUA","E34004986","Total",11237,5536,5701,11163,74,99,340.50,33.0
"2011","Sevenoaks BUA","E34004987","Total",29506,14341,15165,28685,821,748,1173.00,25.2
"2011","Carlisle BUA","E34004988","Total",78470,38180,40290,77431,1039,684,2011.25,39.0
"2011","Skelmanthorpe/Clayton West BUA","E34004989","Total",8580,4194,4386,8490,90,123,261.00,32.9
"2011","Shalmsford Street BUA","E34004990","Total",3928,1936,1992,3908,20,40,133.00,29.5
"2011","Bromsgrove BUA","E34004991","Total",49117,23961,25156,48186,931,749,1532.75,32.0
"2011","Wetherby BUA","E34004992","Total",13572,6623,6949,13294,278,274,503.00,27.0
"2011","Bedford BUA","E34004993","Total",106940,52611,54329,104463,2477,1401,2481.50,43.1
"2011","Ballinger Common/Lee Common BUA","E34004994","Total",750,373,377,750,0,27,57.00,13.2
"2011","Limpley Stoke BUA","E34004995","Total",1092,527,565,1085,7,34,105.00,10.4
"2011","Bicester BUA","E34004996","Total",33846,16627,17219,33707,139,329,828.25,40.9
"2011","Redruth BUA","E34004997","Total",42690,20741,21949,42396,294,278,1361.00,31.4
"2011","Tyneside BUA","E34004998","Total",774891,380541,394350,760748,14143,5900,18051.50,42.9
"2011","Tamworth BUA","E34004999","Total",81964,40251,41713,81564,400,733,2068.25,39.6
"2011","Ryde BUA","E34005000","Total",26082,12565,13517,25524,558,282,764.25,34.1
"2011","West Midlands BUA","E34005001","Total",2440986,1199563,1241423,2406893,34093,21584,59887.98,40.8
"2011","Collett's Green BUA","E34005002","Total",1538,745,793,1538,0,41,80.25,19.2
"2011","Wilsden BUA","E34005003","Total",5524,2630,2894,5463,61,97,153.25,36.0
"2011","Grassington BUA","E34005004","Total",1792,817,975,1716,76,40,72.75,24.6
"2011","Trowbridge BUA","E34005005","Total",40952,20040,20912,40567,385,466,1097.75,37.3
"2011","Upper Farringdon/Lower Farringdon BUA","E34005006","Total",664,333,331,664,0,27,59.50,11.2
"2011","Letchworth Garden City BUA","E34005007","Total",43529,21197,22332,42987,542,624,1212.50,35.9
"2011","Waterbeach BUA","E34005008","Total",5795,3122,2673,5296,499,73,295.75,19.6
"2011","Basingstoke BUA","E34005009","Total",107642,53240,54402,107008,634,1326,2939.75,36.6
"2011","Leekbrook BUA","E34005010","Total",968,465,503,957,11,15,54.75,17.7
"2011","Cowes BUA","E34005011","Total",21226,10286,10940,20934,292,232,650.50,32.6
"2011","Plymouth BUA","E34005012","Total",260203,128559,131644,254853,5350,2019,5973.01,43.6
"2011","Bude BUA","E34005013","Total",7011,3398,3613,6901,110,95,241.75,29.0
"2011","Knockholt Pound/Halstead BUA","E34005014","Total",1540,762,778,1540,0,36,127.50,12.1
"2011","Kendal BUA","E34005015","Total",29147,14144,15003,28723,424,441,857.50,34.0
"2011","Fairford Airfield BUA","E34005016","Total",828,415,413,828,0,19,378.50,2.2
"2011","Dartmouth BUA","E34005017","Total",5610,2732,2878,5586,24,65,184.50,30.4
"2011","Workington BUA","E34005018","Total",27120,13301,13819,26926,194,220,756.75,35.8
"2011","Coldeast BUA","E34005019","Total",1289,641,648,1289,0,15,68.50,18.8
"2011","Ackworth Moor Top BUA","E34005020","Total",6902,3363,3539,6806,96,92,211.25,32.7
"2011","Newick BUA","E34005021","Total",3726,1860,1866,3634,92,112,245.50,15.2
"2011","Briston BUA","E34005022","Total",3057,1502,1555,3057,0,25,141.75,21.6
"2011","The Sands/Moor Park BUA","E34005023","Total",765,378,387,765,0,36,164.00,4.7
"2011","Hardington Moor/Hardington Mandeville BUA","E34005024","Total",585,299,286,585,0,15,46.50,12.6
"2011","Wallingford BUA","E34005025","Total",10348,4952,5396,10220,128,188,333.50,31.0
"2011","Ingatestone BUA","E34005026","Total",5620,2656,2964,5604,16,98,227.50,24.7
"2011","Nether Padley BUA","E34005027","Total",909,475,434,897,12,31,49.00,18.6
"2011","Adwick le Street BUA","E34005028","Total",19481,9548,9933,19325,156,103,598.00,32.6
"2011","Cirencester BUA","E34005029","Total",17153,8282,8871,16932,221,231,444.75,38.6
"2011","Lincoln BUA","E34005030","Total",114879,56239,58640,108647,6232,1169,3265.25,35.2
"2011","Bournemouth/Poole BUA","E34005031","Total",466266,227748,238518,457721,8545,4939,13098.50,35.6
"2011","Sharpthorne/West Hoathly BUA","E34005032","Total",1446,724,722,1446,0,37,76.25,19.0
"2011","Fernhurst BUA","E34005033","Total",2106,992,1114,2106,0,48,141.75,14.9
"2011","Harwich BUA","E34005034","Total",20723,10085,10638,20560,163,151,560.75,37.0
"2011","Sheringham BUA","E34005035","Total",8090,3785,4305,7881,209,106,282.00,28.7
"2011","York BUA","E34005036","Total",153717,75043,78674,147385,6332,1722,3402.50,45.2
"2011","Selby BUA","E34005037","Total",24859,12160,12699,24618,241,245,697.75,35.6
"2011","Westhoughton BUA","E34005038","Total",26260,12977,13283,26227,33,335,623.25,42.1
"2011","Preston BUA","E34005039","Total",313332,155245,158087,306102,7230,3372,8240.75,38.0
"2011","Medway Towns BUA","E34005040","Total",243931,121004,122927,240080,3851,2360,5215.75,46.8
"2011","Taunton BUA","E34005041","Total",64621,30976,33645,62844,1777,901,1785.25,36.2
"2011","East Tilbury BUA","E34005042","Total",5471,2680,2791,5446,25,53,111.00,49.3
"2011","Badsey BUA","E34005043","Total",2601,1300,1301,2576,25,38,128.25,20.3
"2011","Bideford BUA","E34005044","Total",28672,13876,14796,28219,453,279,869.50,33.0
"2011","Herne Bay/Whitstable BUA","E34005045","Total",70485,33638,36847,69382,1103,693,1906.50,37.0
"2011","Southend-on-Sea BUA","E34005046","Total",295310,144377,150933,292299,3011,3159,7183.25,41.1
"2011","Great Moulton/Sneath Common BUA","E34005047","Total",751,376,375,747,4,7,55.50,13.5
"2011","Colchester BUA","E34005048","Total",121859,60223,61636,118582,3277,1399,3265.00,37.3
"2011","Midsomer Norton/Radstock BUA","E34005049","Total",27136,13357,13779,26907,229,296,781.50,34.7
"2011","Hunstanton BUA","E34005050","Total",9332,4329,5003,9034,298,111,520.25,17.9
"2011","Burnham-on-Crouch BUA","E34005051","Total",7561,3752,3809,7549,12,95,244.25,31.0
"2011","Hackleton BUA","E34005052","Total",1408,697,711,1408,0,26,49.25,28.6
"2011","Camblesforth BUA","E34005053","Total",2056,1032,1024,1984,72,24,285.75,7.2
"2011","Greater Manchester BUA","E34005054","Total",2553379,1260660,1292719,2511701,41678,26210,63025.25,40.5
"2011","Kelvedon BUA","E34005055","Total",5322,2653,2669,5224,98,81,166.00,32.1
"2011","Milton Keynes BUA","E34005056","Total",229941,113794,116147,227982,1959,3038,6252.00,36.8
"2011","Redditch BUA","E34005057","Total",82253,40846,41407,81871,382,790,2223.00,37.0
"2011","Chester BUA","K05000008","Total",90524,43907,46617,89262,1262,1254,2552.25,35.5
"2011","Farndon/Holt BUA","K05000010","Total",2766,1321,1445,2740,26,44,94.50,29.3
"2011","Chepstow BUA","K05000009","Total",16169,7784,8385,15902,267,242,511.25,31.6
"2011","Knighton (Powys) BUA","K05000001","Total",3007,1492,1515,2975,32,45,121.75,24.7
"2011","Hay-on-Wye BUA","K05000002","Total",1954,944,1010,1924,30,14,82.25,23.8
"2011","Churchstoke BUA","K05000003","Total",708,339,369,672,36,11,27.25,26.0
"2011","Chirk BUA","K05000004","Total",4007,1937,2070,3985,22,37,163.75,24.5
"2011","Presteigne BUA","K05000005","Total",2056,1004,1052,2044,12,31,89.00,23.1
"2011","Threapwood BUA","K05000006","Total",351,166,185,351,0,11,59.75,5.9
"2011","Pant BUA","K05000007","Total",1998,978,1020,1992,6,21,122.00,16.4
"2011","Rossett BUA","K05000011","Total",2279,1124,1155,2279,0,48,113.75,20.0
"2011","Crundale BUA","W37000001","Total",584,278,306,584,0,6,25.00,23.4
"2011","Llangwm BUA","W37000002","Total",875,430,445,863,12,10,33.50,26.1
"2011","Llanybyther BUA","W37000003","Total",1218,604,614,1200,18,12,73.50,16.6
"2011","Bontnewydd BUA","W37000004","Total",951,470,481,906,45,13,26.50,35.9
"2011","Llanberis BUA","W37000005","Total",1844,913,931,1783,61,30,54.75,33.7
"2011","Glyn Ceiriog BUA","W37000006","Total",804,398,406,804,0,15,36.75,21.9
"2011","Ynysybwl BUA","W37000007","Total",3503,1690,1813,3503,0,35,90.00,38.9
"2011","Y Felinheli BUA","W37000008","Total",2284,1145,1139,2212,72,33,59.25,38.5
"2011","Llanddewi Brefi BUA","W37000009","Total",640,307,333,640,0,15,20.25,31.6
"2011","Grovesend BUA","W37000010","Total",1131,540,591,1086,45,8,35.00,32.3
"2011","Pentre Halkyn BUA","W37000011","Total",1094,547,547,1094,0,8,44.50,24.6
"2011","Penrhyn-coch BUA","W37000012","Total",1316,659,657,1316,0,26,41.50,31.7
"2011","Llandevaud BUA","W37000013","Total",376,189,187,368,8,10,24.25,15.5
"2011","Clawdd Poncen BUA","W37000014","Total",300,144,156,300,0,2,21.75,13.8
"2011","Borth BUA","W37000015","Total",1269,625,644,1253,16,19,77.00,16.5
"2011","Soughton BUA","W37000016","Total",1710,813,897,1710,0,35,50.50,33.9
"2011","Three Crosses BUA","W37000017","Total",1583,742,841,1583,0,27,58.00,27.3
"2011","Llansanffraid Glan Conwy BUA","W37000018","Total",1735,840,895,1733,2,25,65.25,26.6
"2011","Newborough (Isle of Anglesey) BUA","W37000019","Total",892,416,476,892,0,1,36.75,24.3
"2011","Ruthin BUA","W37000020","Total",5461,2661,2800,5282,179,89,196.00,27.9
"2011","Tircoed BUA","W37000021","Total",884,427,457,884,0,6,21.50,41.1
"2011","South Cornelly BUA","W37000022","Total",471,209,262,408,63,4,21.75,21.7
"2011","Llanfechell BUA","W37000023","Total",589,287,302,589,0,9,26.25,22.4
"2011","Groes-faen BUA","W37000024","Total",685,329,356,683,2,12,26.75,25.6
"2011","Pant-yr-awel BUA","W37000025","Total",734,367,367,734,0,2,22.75,32.3
"2011","Henllan BUA","W37000026","Total",862,432,430,862,0,18,31.75,27.1
"2011","Ferryside BUA","W37000027","Total",846,414,432,837,9,8,45.75,18.5
"2011","Gwynfryn BUA","W37000028","Total",303,156,147,303,0,7,24.25,12.5
"2011","Abermule BUA","W37000029","Total",900,434,466,897,3,11,26.25,34.3
"2011","Pontneddfechan BUA","W37000030","Total",366,193,173,364,2,3,22.00,16.6
"2011","Trelogan BUA","W37000031","Total",671,331,340,671,0,4,30.50,22.0
"2011","Trimsaran BUA","W37000032","Total",1584,749,835,1582,2,13,64.50,24.6
"2011","Llanrhidian BUA","W37000033","Total",512,253,259,512,0,15,20.50,25.0
"2011","Resolven BUA","W37000034","Total",2068,1009,1059,2068,0,11,56.75,36.4
"2011","Sudbrook BUA","W37000035","Total",322,173,149,322,0,2,24.50,13.1
"2011","Fishguard BUA","W37000036","Total",3419,1623,1796,3364,55,42,116.50,29.3
"2011","Llanbedr-Dyffryn-Clwyd BUA","W37000037","Total",306,138,168,306,0,9,20.50,14.9
"2011","Conwy BUA","W37000038","Total",3873,1864,2009,3849,24,60,134.50,28.8
"2011","Gresford BUA","W37000039","Total",5010,2421,2589,4908,102,101,169.75,29.5
"2011","Berriew BUA","W37000040","Total",283,138,145,279,4,1,20.75,13.6
"2011","Letterston BUA","W37000041","Total",1245,601,644,1245,0,17,56.00,22.2
"2011","Bull Bay BUA","W37000042","Total",287,148,139,287,0,5,23.75,12.1
"2011","Rhosneigr BUA","W37000043","Total",1008,489,519,992,16,16,57.50,17.5
"2011","Tenby BUA","W37000044","Total",4696,2240,2456,4521,175,68,143.00,32.8
"2011","Caergeiliog BUA","W37000045","Total",355,168,187,355,0,4,22.50,15.8
"2011","Broughton (Flintshire) BUA","W37000046","Total",5974,2991,2983,5974,0,43,496.75,12.0
"2011","The Narth BUA","W37000047","Total",369,186,183,369,0,9,32.75,11.3
"2011","Llandovery BUA","W37000048","Total",2065,1009,1056,1908,157,44,84.00,24.6
"2011","Tavernspite BUA","W37000049","Total",349,168,181,349,0,7,21.50,16.2
"2011","Bryncrug BUA","W37000050","Total",622,307,315,617,5,15,29.25,21.3
"2011","Crossgates BUA","W37000051","Total",327,163,164,325,2,10,26.50,12.3
"2011","Llechryd BUA","W37000052","Total",875,440,435,875,0,7,47.75,18.3
"2011","Argoed BUA","W37000053","Total",891,443,448,882,9,5,28.50,31.3
"2011","Llanyre BUA","W37000054","Total",279,136,143,279,0,4,21.50,13.0
"2011","Ystrad Aeron BUA","W37000055","Total",596,298,298,596,0,10,26.50,22.5
"2011","Deiniolen BUA","W37000056","Total",1379,677,702,1379,0,7,33.75,40.9
"2011","Penley BUA","W37000057","Total",606,312,294,604,2,10,29.25,20.7
"2011","Betws-yn-Rhos BUA","W37000058","Total",312,153,159,312,0,9,24.00,13.0
"2011","Mynyddygarreg BUA","W37000059","Total",299,139,160,293,6,2,22.25,13.4
"2011","Blaengwynfi BUA","W37000060","Total",1362,671,691,1362,0,4,22.75,59.9
"2011","Abercrave BUA","W37000061","Total",696,327,369,696,0,6,31.25,22.3
"2011","Rhydymwyn BUA","W37000062","Total",537,253,284,536,1,14,28.50,18.8
"2011","Cwrt Y Gollen BUA","W37000063","Total",487,247,240,487,0,17,22.25,21.9
"2011","Cefn Cribwr BUA","W37000064","Total",1324,629,695,1324,0,6,43.75,30.3
"2011","Trefor BUA","W37000065","Total",814,413,401,814,0,10,25.50,31.9
"2011","Llandyrnog BUA","W37000066","Total",747,387,360,693,54,21,20.50,36.4
"2011","Cemaes BUA","W37000067","Total",1187,572,615,1187,0,7,48.75,24.3
"2011","Llanarth BUA","W37000068","Total",503,259,244,502,1,3,27.75,18.1
"2011","Pontyberem BUA","W37000069","Total",1695,809,886,1691,4,18,77.00,22.0
"2011","Parc-Seymour BUA","W37000070","Total",744,367,377,738,6,16,26.50,28.1
"2011","Lampeter BUA","W37000071","Total",2970,1507,1463,2445,525,61,117.25,25.3
"2011","Newbridge-on-Wye BUA","W37000072","Total",566,283,283,562,4,5,28.50,19.9
"2011","Tal-y-bont (Ceredigion) BUA","W37000073","Total",662,337,325,662,0,9,32.50,20.4
"2011","Pontrhydfendigaid BUA","W37000074","Total",712,334,378,712,0,14,27.50,25.9
"2011","Dwyran BUA","W37000075","Total",603,294,309,603,0,8,29.50,20.4
"2011","Blaenau Ffestiniog BUA","W37000076","Total",3662,1813,1849,3655,7,30,117.75,31.1
"2011","Waunfawr BUA","W37000077","Total",1190,577,613,1188,2,19,47.75,24.9
"2011","Froncysyllte BUA","W37000078","Total",606,313,293,605,1,2,27.00,22.4
"2011","Llangristiolus BUA","W37000079","Total",384,192,192,384,0,11,20.25,19.0
"2011","Trefriw BUA","W37000080","Total",605,298,307,604,1,10,29.75,20.3
"2011","Llanellen BUA","W37000081","Total",506,251,255,506,0,3,21.25,23.8
"2011","Pwllmeyric BUA","W37000082","Total",635,339,296,608,27,34,20.75,30.6
"2011","Pont Rhyd-y-cyff BUA","W37000083","Total",1505,732,773,1505,0,17,37.00,40.7
"2011","Talybont-on-Usk BUA","W37000084","Total",219,115,104,219,0,8,21.50,10.2
"2011","Forden BUA","W37000085","Total",745,363,382,736,9,9,22.50,33.1
"2011","Rhuddlan BUA","W37000086","Total",3709,1774,1935,3707,2,41,92.00,40.3
"2011","Pentlepoir BUA","W37000087","Total",1211,598,613,1178,33,15,64.00,18.9
"2011","Rhosybol BUA","W37000088","Total",712,369,343,709,3,5,21.50,33.1
"2011","Leeswood BUA","W37000089","Total",2282,1128,1154,2282,0,29,68.75,33.2
"2011","Betws-Y-Coed BUA","W37000090","Total",255,129,126,223,32,1,23.00,11.1
"2011","Morfa Nefyn BUA","W37000091","Total",857,412,445,841,16,13,45.00,19.0
"2011","Abertillery BUA","W37000092","Total",10946,5382,5564,10856,90,67,226.25,48.4
"2011","Machynlleth BUA","W37000093","Total",2235,1074,1161,2197,38,17,90.00,24.8
"2011","Pencoed BUA","W37000094","Total",9166,4589,4577,9135,31,77,223.00,41.1
"2011","Carway BUA","W37000095","Total",672,339,333,672,0,9,22.75,29.5
"2011","Penmaenmawr BUA","W37000096","Total",2535,1214,1321,2496,39,31,85.50,29.6
"2011","St Nicholas BUA","W37000097","Total",417,202,215,417,0,11,24.50,17.0
"2011","Llanrhystud BUA","W37000098","Total",646,319,327,646,0,11,26.50,24.4
"2011","Moelfre BUA","W37000099","Total",710,334,376,710,0,10,39.50,18.0
"2011","Newtown (Powys) BUA","W37000100","Total",11357,5560,5797,11226,131,127,465.00,24.4
"2011","Bronllys BUA","W37000101","Total",491,235,256,469,22,5,21.00,23.4
"2011","Ogmore-by-Sea BUA","W37000102","Total",878,423,455,878,0,19,44.00,20.0
"2011","Usk BUA","W37000103","Total",2834,1563,1271,2438,396,53,77.50,36.6
"2011","Llanharry BUA","W37000104","Total",3035,1485,1550,3024,11,21,80.00,37.9
"2011","Pembroke Dock BUA","W37000105","Total",9753,4841,4912,9672,81,79,347.25,28.1
"2011","Johnston BUA","W37000106","Total",1941,901,1040,1875,66,20,65.25,29.7
"2011","Rosemarket BUA","W37000107","Total",613,297,316,606,7,1,21.75,28.2
"2011","Llandissilio BUA","W37000108","Total",513,253,260,508,5,7,28.00,18.3
"2011","Kerry BUA","W37000109","Total",785,391,394,785,0,17,27.25,28.8
"2011","Northop BUA","W37000110","Total",1001,488,513,1001,0,15,35.00,28.6
"2011","Pyle BUA","W37000111","Total",13701,6728,6973,13683,18,104,389.50,35.2
"2011","Pentyrch BUA","W37000112","Total",2287,1095,1192,2272,15,80,70.25,32.6
"2011","St Asaph BUA","W37000113","Total",3355,1621,1734,3263,92,57,129.75,25.9
"2011","Brynna BUA","W37000114","Total",6686,3269,3417,6686,0,81,137.25,48.7
"2011","Pontycymer BUA","W37000115","Total",4288,2131,2157,4288,0,29,82.00,52.3
"2011","Bryn BUA","W37000116","Total",923,468,455,921,2,12,31.25,29.5
"2011","Dolgarrog BUA","W37000117","Total",446,227,219,446,0,8,21.50,20.7
"2011","Machen BUA","W37000118","Total",2362,1158,1204,2357,5,46,86.75,27.2
"2011","Gwernymynydd BUA","W37000119","Total",1141,539,602,1140,1,20,55.75,20.5
"2011","Penygroes BUA","W37000120","Total",1793,839,954,1770,23,26,57.00,31.5
"2011","Glyncoch BUA","W37000121","Total",4020,1981,2039,4020,0,36,82.50,48.7
"2011","Cross Inn BUA","W37000122","Total",292,144,148,292,0,2,22.00,13.3
"2011","Caerleon BUA","W37000123","Total",8747,4233,4514,8613,134,210,252.75,34.6
"2011","Govilon BUA","W37000124","Total",1447,704,743,1442,5,20,49.00,29.5
"2011","Rhosesmor BUA","W37000125","Total",575,281,294,575,0,11,20.50,28.0
"2011","Overton (Wrexham) BUA","W37000126","Total",965,468,497,965,0,12,31.75,30.4
"2011","Cwm BUA","W37000127","Total",2739,1356,1383,2734,5,23,48.25,56.8
"2011","Whitland BUA","W37000128","Total",1514,741,773,1514,0,15,65.00,23.3
"2011","Mountain Ash BUA","W37000129","Total",11230,5367,5863,11102,128,65,186.75,60.1
"2011","Laugharne BUA","W37000130","Total",817,395,422,817,0,14,45.25,18.1
"2011","Freshwater East BUA","W37000131","Total",250,125,125,250,0,8,27.50,9.1
"2011","Llangors BUA","W37000132","Total",371,187,184,340,31,11,23.75,15.6
"2011","Blaenannerch BUA","W37000133","Total",131,72,59,131,0,1,69.00,1.9
"2011","Tregynon BUA","W37000134","Total",892,465,427,885,7,16,27.50,32.4
"2011","Llanmadoc BUA","W37000135","Total",365,186,179,360,5,9,23.00,15.9
"2011","Gilwern BUA","W37000136","Total",2263,1089,1174,2188,75,41,87.25,25.9
"2011","Hengell Uchaf Estate BUA","W37000137","Total",388,180,208,377,11,1,22.25,17.4
"2011","Denbigh BUA","W37000138","Total",8514,4232,4282,8277,237,114,238.50,35.7
"2011","Valley BUA","W37000139","Total",2361,1156,1205,2349,12,17,72.25,32.7
"2011","Llanddona BUA","W37000140","Total",691,347,344,691,0,12,33.25,20.8
"2011","Sennybridge BUA","W37000141","Total",230,108,122,230,0,5,47.00,4.9
"2011","Penrhyndeudraeth BUA","W37000142","Total",1546,774,772,1539,7,18,70.50,21.9
"2011","Llanwrtyd Wells BUA","W37000143","Total",630,316,314,603,27,12,27.00,23.3
"2011","Llan Ffestiniog BUA","W37000144","Total",864,406,458,844,20,11,25.50,33.9
"2011","Llanerchymedd BUA","W37000145","Total",1133,581,552,1133,0,13,33.50,33.8
"2011","Pontarddulais BUA","W37000146","Total",9073,4420,4653,9001,72,94,282.00,32.2
"2011","Abertridwr BUA","W37000147","Total",6504,3223,3281,6483,21,48,127.50,51.0
"2011","Llansanffraid-ym-Mechain BUA","W37000148","Total",747,354,393,703,44,6,40.25,18.6
"2011","Glanaman BUA","W37000149","Total",4384,2134,2250,4357,27,41,192.00,22.8
"2011","Talysarn BUA","W37000150","Total",1086,525,561,1086,0,4,30.50,35.6
"2011","Nantgaredig BUA","W37000151","Total",524,247,277,524,0,18,20.25,25.9
"2011","Talgarth BUA","W37000152","Total",1268,620,648,1233,35,17,53.75,23.6
"2011","Henfynyw BUA","W37000153","Total",512,234,278,512,0,8,21.25,24.1
"2011","Llanon BUA","W37000154","Total",598,291,307,578,20,10,48.00,12.5
"2011","Montgomery BUA","W37000155","Total",986,466,520,986,0,11,45.50,21.7
"2011","Pentraeth BUA","W37000156","Total",557,266,291,557,0,6,27.25,20.4
"2011","Reynoldston BUA","W37000157","Total",439,225,214,439,0,7,29.75,14.8
"2011","Trawsfynydd BUA","W37000158","Total",628,305,323,628,0,7,20.75,30.3
"2011","Waterston BUA","W37000159","Total",335,164,171,335,0,5,167.00,2.0
"2011","St Brides Major BUA","W37000160","Total",741,359,382,741,0,24,28.25,26.2
"2011","St Donat's BUA","W37000161","Total",555,240,315,216,339,15,20.50,27.1
"2011","Harlech BUA","W37000162","Total",1762,871,891,1697,65,14,132.00,13.3
"2011","Capel Bangor BUA","W37000163","Total",256,119,137,256,0,9,22.25,11.5
"2011","Cwmavon BUA","W37000164","Total",5336,2581,2755,5301,35,60,145.00,36.8
"2011","Creigiau BUA","W37000165","Total",2380,1164,1216,2376,4,80,66.00,36.1
"2011","Trefnant BUA","W37000166","Total",993,477,516,918,75,9,24.75,40.1
"2011","Peniel BUA","W37000167","Total",358,170,188,344,14,7,26.50,13.5
"2011","Coedhirwaun BUA","W37000168","Total",1299,627,672,1299,0,19,23.75,54.7
"2011","Llanhilleth BUA","W37000169","Total",2990,1537,1453,2990,0,17,77.75,38.5
"2011","Maenclochog BUA","W37000170","Total",731,352,379,731,0,19,25.75,28.4
"2011","St Arvans BUA","W37000171","Total",765,382,383,765,0,22,28.00,27.3
"2011","Craig-cefn-parc BUA","W37000172","Total",874,448,426,874,0,6,39.00,22.4
"2011","Brecon BUA","W37000173","Total",8250,3966,4284,7887,363,158,259.25,31.8
"2011","Llanrhaeadr-ym-Mochnant BUA","W37000174","Total",408,203,205,408,0,5,22.00,18.5
"2011","Pontlliw BUA","W37000175","Total",1645,795,850,1645,0,16,46.50,35.4
"2011","Talacre BUA","W37000176","Total",347,163,184,347,0,1,68.50,5.1
"2011","Cil-y-coed BUA","W37000177","Total",11200,5545,5655,11156,44,141,314.75,35.6
"2011","Markham BUA","W37000178","Total",1495,732,763,1492,3,10,34.25,43.6
"2011","Flint Mountain BUA","W37000179","Total",670,335,335,647,23,14,32.00,20.9
"2011","Penyffordd BUA","W37000180","Total",3554,1770,1784,3554,0,47,94.50,37.6
"2011","Four Crosses BUA","W37000181","Total",1438,691,747,1434,4,19,63.75,22.6
"2011","Llannon BUA","W37000182","Total",869,448,421,867,2,19,28.00,31.0
"2011","St Florence BUA","W37000183","Total",756,374,382,755,1,14,32.75,23.1
"2011","Crickhowell BUA","W37000184","Total",2063,990,1073,2054,9,42,83.50,24.7
"2011","Lixwm BUA","W37000185","Total",610,309,301,610,0,12,29.50,20.7
"2011","Kidwelly BUA","W37000186","Total",2782,1331,1451,2766,16,24,111.25,25.0
"2011","Pembroke BUA","W37000187","Total",7552,3644,3908,7427,125,94,258.00,29.3
"2011","Llay BUA","W37000188","Total",4681,2305,2376,4619,62,39,183.75,25.5
"2011","Llanfyllin BUA","W37000189","Total",1105,579,526,1074,31,17,53.75,20.6
"2011","Hill Mountain BUA","W37000190","Total",673,318,355,673,0,11,35.00,19.2
"2011","Tonyrefail BUA","W37000191","Total",9317,4557,4760,9210,107,74,219.50,42.4
"2011","Bedlinog BUA","W37000192","Total",1112,545,567,1112,0,3,29.25,38.0
"2011","Deri BUA","W37000193","Total",1006,495,511,1006,0,6,24.50,41.1
"2011","Penperlleni BUA","W37000194","Total",1311,624,687,1291,20,9,41.00,32.0
"2011","Dyffryn Cellwen BUA","W37000195","Total",727,367,360,724,3,6,23.75,30.6
"2011","Llangattock BUA","W37000196","Total",662,311,351,632,30,16,32.25,20.5
"2011","Cwmann BUA","W37000197","Total",872,432,440,872,0,12,32.00,27.2
"2011","Spittal BUA","W37000198","Total",494,245,249,487,7,18,25.75,19.2
"2011","Waunllapria BUA","W37000199","Total",714,371,343,714,0,11,27.50,26.0
"2011","Llanwrda BUA","W37000200","Total",287,134,153,287,0,4,21.00,13.7
"2011","Criccieth BUA","W37000201","Total",1753,823,930,1696,57,29,87.75,20.0
"2011","Bangor-on-Dee BUA","W37000202","Total",1110,547,563,1106,4,20,37.50,29.6
"2011","Clunderwen BUA","W37000203","Total",677,317,360,677,0,13,28.00,24.2
"2011","Penally BUA","W37000204","Total",848,404,444,843,5,10,55.25,15.3
"2011","Benllech BUA","W37000205","Total",2236,1062,1174,2229,7,26,119.50,18.7
"2011","Malltraeth BUA","W37000206","Total",255,118,137,255,0,1,20.50,12.4
"2011","Fochriw BUA","W37000207","Total",1250,611,639,1250,0,11,27.00,46.3
"2011","Guilsfield BUA","W37000208","Total",1220,584,636,1220,0,11,49.00,24.9
"2011","Llandrindod Wells BUA","W37000209","Total",5309,2587,2722,5211,98,71,215.25,24.7
"2011","Tregarth BUA","W37000210","Total",1307,640,667,1305,2,12,55.25,23.7
"2011","Seven Sisters BUA","W37000211","Total",2123,1052,1071,2094,29,4,87.25,24.3
"2011","Llanbedr BUA","W37000212","Total",385,188,197,376,9,3,29.50,13.1
"2011","Pen-clawdd BUA","W37000213","Total",1935,924,1011,1907,28,35,77.25,25.0
"2011","Bryngwran BUA","W37000214","Total",405,204,201,391,14,1,21.75,18.6
"2011","Higher Kinnerton BUA","W37000215","Total",1697,816,881,1697,0,40,41.75,40.6
"2011","Cilgerran BUA","W37000216","Total",865,414,451,865,0,11,39.50,21.9
"2011","Blaenau BUA","W37000217","Total",425,216,209,423,2,5,24.25,17.5
"2011","Arddleen BUA","W37000218","Total",418,214,204,418,0,7,24.50,17.1
"2011","Underwood BUA","W37000219","Total",1976,980,996,1976,0,13,35.25,56.1
"2011","Llandysul BUA","W37000220","Total",1484,711,773,1456,28,26,62.25,23.8
"2011","Heol-y-Cyw BUA","W37000221","Total",538,281,257,538,0,3,25.50,21.1
"2011","Bethel BUA","W37000222","Total",1171,574,597,1171,0,23,34.00,34.4
"2011","Coelbren BUA","W37000223","Total",537,256,281,515,22,4,31.50,17.0
"2011","Beaumaris BUA","W37000224","Total",1370,657,713,1368,2,26,47.25,29.0
"2011","Milford Haven BUA","W37000225","Total",13582,6643,6939,13541,41,134,376.50,36.1
"2011","Rogiet BUA","W37000226","Total",1813,882,931,1813,0,21,45.50,39.8
"2011","Dwygyfylchi BUA","W37000227","Total",1355,655,700,1354,1,11,52.00,26.1
"2011","Llanbedrog BUA","W37000228","Total",613,304,309,598,15,20,58.75,10.4
"2011","Rhossili BUA","W37000229","Total",278,140,138,275,3,5,20.25,13.7
"2011","New Tredegar BUA","W37000230","Total",4208,2094,2114,4178,30,22,91.50,46.0
"2011","Bodelwyddan BUA","W37000231","Total",1794,881,913,1790,4,19,84.00,21.4
"2011","Norton (Powys) BUA","W37000232","Total",375,184,191,375,0,4,24.00,15.6
"2011","Wick (The Vale of Glamorgan) BUA","W37000233","Total",698,355,343,698,0,35,27.50,25.4
"2011","Cross Lanes BUA","W37000234","Total",609,319,290,605,4,18,20.75,29.3
"2011","Waun-Lwyd BUA","W37000235","Total",1556,798,758,1555,1,13,52.75,29.5
"2011","Llansteffan BUA","W37000236","Total",424,196,228,424,0,4,33.75,12.6
"2011","Llwyngwril BUA","W37000237","Total",526,268,258,526,0,12,42.00,12.5
"2011","Caerwys BUA","W37000238","Total",950,464,486,950,0,24,33.25,28.6
"2011","Llanfihangel yn Nhowyn BUA","W37000239","Total",757,377,380,757,0,2,20.75,36.5
"2011","Llanilar BUA","W37000240","Total",1085,533,552,1035,50,19,29.75,36.5
"2011","Llandogo BUA","W37000241","Total",547,246,301,495,52,20,33.75,16.2
"2011","Llanfair Caereinion BUA","W37000242","Total",1055,507,548,1052,3,14,50.25,21.0
"2011","Llandudno BUA","W37000243","Total",15371,7323,8048,14612,759,152,393.00,39.1
"2011","Pen-twyn (Caerphilly) BUA","W37000244","Total",1540,756,784,1540,0,13,30.00,51.3
"2011","Cosheston BUA","W37000245","Total",828,409,419,828,0,16,29.75,27.8
"2011","Rhayader BUA","W37000246","Total",1824,860,964,1739,85,21,79.75,22.9
"2011","Pencader BUA","W37000247","Total",1107,557,550,1084,23,7,36.50,30.3
"2011","Hundleton BUA","W37000248","Total",435,212,223,435,0,13,21.25,20.5
"2011","Rhoose BUA","W37000249","Total",6160,3010,3150,6154,6,72,352.75,17.5
"2011","Llanidloes BUA","W37000250","Total",2929,1443,1486,2886,43,42,107.00,27.4
"2011","Aberaeron BUA","W37000251","Total",1422,673,749,1396,26,28,82.50,17.2
"2011","Hook (Pembrokeshire) BUA","W37000252","Total",838,412,426,838,0,16,52.50,16.0
"2011","Crymych BUA","W37000253","Total",704,356,348,704,0,9,34.25,20.6
"2011","Ferndale BUA","W37000254","Total",7338,3592,3746,7300,38,25,146.75,50.0
"2011","Penrhiw-llan BUA","W37000255","Total",521,244,277,494,27,5,26.50,19.7
"2011","Crynant BUA","W37000256","Total",1602,774,828,1598,4,11,58.25,27.5
"2011","Amlwch BUA","W37000257","Total",3211,1567,1644,3182,29,30,129.50,24.8
"2011","Llanrwst BUA","W37000258","Total",3323,1563,1760,3268,55,22,108.75,30.6
"2011","Bonvilston BUA","W37000259","Total",392,190,202,392,0,14,24.00,16.3
"2011","Tregaron BUA","W37000260","Total",1213,595,618,1198,15,21,47.00,25.8
"2011","Ewenny BUA","W37000261","Total",768,373,395,768,0,26,46.50,16.5
"2011","Clyro BUA","W37000262","Total",781,402,379,767,14,14,23.50,33.2
"2011","New Brighton BUA","W37000263","Total",838,410,428,838,0,5,28.75,29.1
"2011","Treuddyn BUA","W37000264","Total",1360,665,695,1360,0,15,46.50,29.2
"2011","Aberdovey BUA","W37000265","Total",725,361,364,719,6,11,56.75,12.8
"2011","Gwalchmai BUA","W37000266","Total",715,341,374,697,18,3,26.25,27.2
"2011","Llangoed BUA","W37000267","Total",849,394,455,812,37,12,41.00,20.7
"2011","Tanyfron BUA","W37000268","Total",2090,1053,1037,2090,0,18,38.75,53.9
"2011","Goodwick BUA","W37000269","Total",1720,858,862,1709,11,19,79.25,21.7
"2011","Penparc BUA","W37000270","Total",470,218,252,470,0,10,29.50,15.9
"2011","Llangollen BUA","W37000271","Total",3466,1715,1751,3384,82,34,130.75,26.5
"2011","Tywyn BUA","W37000272","Total",3097,1423,1674,2995,102,37,156.25,19.8
"2011","Mold BUA","W37000273","Total",10058,4880,5178,9986,72,147,335.00,30.0
"2011","Morfa Bychan BUA","W37000274","Total",526,267,259,524,2,10,34.50,15.2
"2011","Templeton BUA","W37000275","Total",627,303,324,627,0,11,43.25,14.5
"2011","Llandinam BUA","W37000276","Total",576,295,281,576,0,12,22.75,25.3
"2011","Bow Street BUA","W37000277","Total",1572,755,817,1553,19,27,44.75,35.1
"2011","Roch BUA","W37000278","Total",463,222,241,463,0,4,30.75,15.1
"2011","Lamphey BUA","W37000279","Total",593,296,297,591,2,9,28.25,21.0
"2011","Jameston BUA","W37000280","Total",634,299,335,629,5,8,20.25,31.3
"2011","Clarbeston Road BUA","W37000281","Total",318,151,167,318,0,5,20.25,15.7
"2011","Solva BUA","W37000282","Total",710,335,375,710,0,20,33.75,21.0
"2011","Bettws BUA","W37000283","Total",2253,1096,1157,2253,0,23,50.75,44.4
"2011","Cynwyd BUA","W37000284","Total",542,276,266,542,0,8,29.00,18.7
"2011","Penysarn BUA","W37000285","Total",595,303,292,595,0,9,21.75,27.4
"2011","Bodedern BUA","W37000286","Total",1051,529,522,1050,1,12,28.25,37.2
"2011","Pont Henri BUA","W37000287","Total",987,479,508,987,0,6,41.00,24.1
"2011","Nefyn BUA","W37000288","Total",1373,670,703,1372,1,11,49.00,28.0
"2011","Pen-y-ffordd BUA","W37000289","Total",748,367,381,734,14,4,23.50,31.8
"2011","Llandeilo BUA","W37000290","Total",1795,838,957,1771,24,29,68.00,26.4
"2011","Llanfair Pwllgwyngyll BUA","W37000291","Total",3107,1487,1620,2979,128,58,94.25,33.0
"2011","Marchwiel BUA","W37000292","Total",1092,542,550,1092,0,12,35.25,31.0
"2011","Barmouth BUA","W37000293","Total",2315,1137,1178,2270,45,23,97.00,23.9
"2011","New Quay BUA","W37000294","Total",694,346,348,694,0,18,48.00,14.5
"2011","Porthcawl BUA","W37000295","Total",15672,7477,8195,15411,261,253,428.00,36.6
"2011","Bala BUA","W37000296","Total",1974,952,1022,1966,8,27,63.50,31.1
"2011","Abersoch BUA","W37000297","Total",783,393,390,777,6,19,91.75,8.5
"2011","Llangefni BUA","W37000298","Total",4864,2317,2547,4833,31,53,200.75,24.2
"2011","St Fagans BUA","W37000299","Total",282,147,135,275,7,6,23.25,12.1
"2011","Chwilog BUA","W37000300","Total",640,310,330,640,0,5,21.00,30.5
"2011","Holyhead BUA","W37000301","Total",11431,5685,5746,11361,70,79,310.50,36.8
"2011","Waungilwen BUA","W37000302","Total",1338,627,711,1338,0,19,54.00,24.8
"2011","Glyncorrwg BUA","W37000303","Total",1096,548,548,1096,0,0,30.75,35.6
"2011","Southgate BUA","W37000304","Total",2004,992,1012,1982,22,40,101.75,19.7
"2011","Wenvoe BUA","W37000305","Total",1155,546,609,1130,25,25,54.75,21.1
"2011","Ynysmaerdy BUA","W37000306","Total",205,94,111,205,0,3,96.25,2.1
"2011","Llangeinor BUA","W37000307","Total",973,506,467,973,0,8,38.00,25.6
"2011","Pontyates BUA","W37000308","Total",1449,721,728,1449,0,16,89.00,16.3
"2011","Llangybi BUA","W37000309","Total",444,227,217,444,0,9,22.75,19.5
"2011","Llandre BUA","W37000310","Total",679,316,363,679,0,14,34.25,19.8
"2011","Corwen BUA","W37000311","Total",477,247,230,477,0,6,24.75,19.3
"2011","Murton (Swansea) BUA","W37000312","Total",3500,1642,1858,3430,70,77,170.50,20.5
"2011","Meidrim BUA","W37000313","Total",582,308,274,579,3,12,25.75,22.6
"2011","Aberfan BUA","W37000314","Total",3547,1782,1765,3545,2,26,80.50,44.1
"2011","Brawdy BUA","W37000315","Total",620,432,188,269,351,3,121.25,5.1
"2011","Crofty BUA","W37000316","Total",1012,499,513,1012,0,18,61.75,16.4
"2011","Bwlchgwyn BUA","W37000317","Total",855,428,427,855,0,12,37.50,22.8
"2011","Caersws BUA","W37000318","Total",816,408,408,816,0,8,30.25,27.0
"2011","Port-Eynon BUA","W37000319","Total",226,108,118,226,0,2,26.25,8.6
"2011","Cwmllynfell BUA","W37000320","Total",1405,696,709,1403,2,19,65.00,21.6
"2011","Llandybie BUA","W37000321","Total",2813,1377,1436,2773,40,22,102.50,27.4
"2011","Raglan BUA","W37000322","Total",1183,556,627,1182,1,10,45.50,26.0
"2011","Abergwili BUA","W37000323","Total",589,285,304,589,0,16,22.75,25.9
"2011","Newcastle Emlyn BUA","W37000324","Total",1883,891,992,1812,71,15,95.00,19.8
"2011","Rhostryfan BUA","W37000325","Total",675,329,346,675,0,13,20.50,32.9
"2011","Broad Haven BUA","W37000326","Total",880,411,469,872,8,20,30.25,29.1
"2011","St Ishmael's BUA","W37000327","Total",478,237,241,476,2,11,23.50,20.3
"2011","Blackmill BUA","W37000328","Total",654,327,327,654,0,3,32.25,20.3
"2011","Cowbridge BUA","W37000329","Total",3804,1818,1986,3785,19,96,156.50,24.3
"2011","Trefechan BUA","W37000330","Total",1042,510,532,1042,0,8,26.75,39.0
"2011","Llanrug BUA","W37000331","Total",1916,925,991,1901,15,19,77.25,24.8
"2011","Narberth BUA","W37000332","Total",2265,1037,1228,2195,70,34,75.50,30.0
"2011","Pendine BUA","W37000333","Total",346,189,157,346,0,1,38.00,9.1
"2011","Hirwaun BUA","W37000334","Total",7247,3499,3748,7237,10,46,196.00,37.0
"2011","Stepaside BUA","W37000335","Total",619,301,318,619,0,10,35.50,17.4
"2011","Pwllheli BUA","W37000336","Total",4076,2024,2052,4036,40,63,144.25,28.3
"2011","Clydach BUA","W37000337","Total",692,332,360,681,11,15,26.75,25.9
"2011","Tredegar BUA","W37000338","Total",14855,7195,7660,14750,105,114,492.50,30.2
"2011","Groeslon BUA","W37000339","Total",880,447,433,865,15,48,45.00,19.6
"2011","Builth Wells BUA","W37000340","Total",2829,1371,1458,2801,28,47,141.75,20.0
"2011","Mostyn BUA","W37000341","Total",1606,774,832,1606,0,7,102.00,15.7
"2011","Barry BUA","W37000342","Total",54673,26362,28311,54218,455,533,1423.00,38.4
"2011","Trearddur BUA","W37000343","Total",1537,737,800,1473,64,15,144.50,10.6
"2011","Ffairfach BUA","W37000344","Total",534,249,285,491,43,4,30.00,17.8
"2011","Pontrhydyfen BUA","W37000345","Total",830,411,419,830,0,3,31.50,26.3
"2011","Llanfairfechan BUA","W37000346","Total",3637,1803,1834,3513,124,34,117.50,31.0
"2011","Abercynon BUA","W37000347","Total",5983,2942,3041,5970,13,36,150.75,39.7
"2011","Menai Bridge BUA","W37000348","Total",4958,2411,2547,4919,39,89,205.25,24.2
"2011","Carno BUA","W37000349","Total",730,362,368,730,0,10,32.75,22.3
"2011","Dolgellau BUA","W37000350","Total",2688,1290,1398,2588,100,50,109.25,24.6
"2011","Llangadog BUA","W37000351","Total",650,319,331,643,7,9,36.50,17.8
"2011","Catbrook BUA","W37000352","Total",412,214,198,406,6,15,43.50,9.5
"2011","Mynytho BUA","W37000353","Total",536,264,272,536,0,5,32.25,16.6
"2011","Monmouth BUA","W37000354","Total",10110,4904,5206,9706,404,225,335.25,30.2
"2011","Sageston BUA","W37000355","Total",857,425,432,857,0,7,56.00,15.3
"2011","Coedpoeth BUA","W37000356","Total",5723,2862,2861,5675,48,48,154.75,37.0
"2011","Porthmadog BUA","W37000357","Total",2981,1465,1516,2886,95,42,128.00,23.3
"2011","Keeston BUA","W37000358","Total",324,151,173,324,0,6,42.50,7.6
"2011","Carmarthen BUA","W37000359","Total",15854,7465,8389,15191,663,219,557.00,28.5
"2011","Dinas Cross BUA","W37000360","Total",815,410,405,808,7,18,44.00,18.5
"2011","Haverfordwest BUA","W37000361","Total",14596,6996,7600,14483,113,174,649.50,22.5
"2011","Llangynidr BUA","W37000362","Total",1036,506,530,1013,23,22,50.25,20.6
"2011","Merthyr Tydfil BUA","W37000363","Total",43820,21376,22444,43408,412,340,1159.25,37.8
"2011","Newport (Pembrokeshire) BUA","W37000364","Total",851,382,469,848,3,17,75.75,11.2
"2011","Llanbradach BUA","W37000365","Total",3746,1859,1887,3746,0,26,65.75,57.0
"2011","Blaenavon BUA","W37000366","Total",5647,2785,2862,5618,29,26,157.50,35.9
"2011","Neyland BUA","W37000367","Total",3708,1768,1940,3698,10,49,133.00,27.9
"2011","St Davids BUA","W37000368","Total",1408,684,724,1365,43,11,59.50,23.7
"2011","Tal-y-bont (Gwynedd) BUA","W37000369","Total",1540,742,798,1515,25,16,109.75,14.0
"2011","Crymlyn Burrows BUA","W37000370","Total",303,151,152,303,0,3,75.00,4.0
"2011","Caerwent BUA","W37000371","Total",1201,603,598,1169,32,21,100.50,12.0
"2011","Pen-twyn (Monmouthshire) BUA","W37000372","Total",358,172,186,348,10,6,20.00,17.9
"2011","Meifod BUA","W37000373","Total",317,157,160,317,0,7,20.00,15.8
"2011","Cerrigydrudion BUA","W37000374","Total",289,140,149,289,0,0,20.00,14.4
"2011","Pentre-cwrt BUA","W37000375","Total",247,138,109,247,0,1,20.00,12.3
"2011","Wrexham BUA","W37000376","Total",65692,32773,32919,64886,806,556,1736.25,37.8
"2011","Llantwit Major BUA","W37000377","Total",14384,7373,7011,13663,721,183,576.25,25.0
"2011","Treharris BUA","W37000378","Total",12352,6062,6290,12243,109,132,316.75,39.0
"2011","Gronant BUA","W37000379","Total",1258,627,631,1258,0,9,149.25,8.4
"2011","Hope (Flintshire) BUA","W37000380","Total",4706,2320,2386,4597,109,58,178.00,26.4
"2011","Kinmel Bay/Abergele BUA","W37000381","Total",18705,8924,9781,18454,251,157,696.50,26.9
"2011","Gorseinon BUA","W37000382","Total",20581,10087,10494,20488,93,217,594.25,34.6
"2011","Hendreforgan/Gilfach Goch BUA","W37000383","Total",4395,2112,2283,4395,0,20,107.25,41.0
"2011","Cardiff BUA","W37000384","Total",447287,219270,228017,434156,13131,4926,10233.52,43.7
"2011","Newport (Newport) BUA","W37000385","Total",306844,150245,156599,304081,2763,2597,8422.00,36.4
"2011","Buckley BUA","W37000386","Total",63576,31397,32179,63294,282,627,2132.50,29.8
"2011","Cardigan BUA","W37000387","Total",5301,2554,2747,5266,35,52,213.00,24.9
"2011","Aberporth BUA","W37000388","Total",1648,806,842,1645,3,21,90.75,18.2
"2011","Caernarfon BUA","W37000389","Total",9730,4733,4997,9638,92,123,301.00,32.3
"2011","Pentre Maelor BUA","W37000390","Total",305,156,149,305,0,7,332.00,0.9
"2011","Ammanford BUA","W37000391","Total",23709,11552,12157,23351,358,243,1118.75,21.2
"2011","Burry Port BUA","W37000392","Total",8310,4041,4269,8271,39,62,298.75,27.8
"2011","Kilgetty BUA","W37000393","Total",1968,963,1005,1963,5,25,80.00,24.6
"2011","Bridgend BUA","W37000394","Total",58380,28565,29815,57880,500,756,1951.25,29.9
"2011","Llanddulas/Mynydd Marian BUA","W37000395","Total",2674,1313,1361,2672,2,37,120.00,22.3
"2011","Maesteg BUA","W37000396","Total",21001,10336,10665,20973,28,140,519.25,40.4
"2011","Gaerwen BUA","W37000397","Total",1551,781,770,1551,0,26,84.25,18.4
"2011","Aberystwyth BUA","W37000398","Total",18749,9583,9166,15258,3491,264,480.50,39.0
"2011","Aberdare BUA","W37000399","Total",31135,15150,15985,30864,271,264,793.25,39.2
"2011","Gwaun-Cae-Gurwen/Brynamman BUA","W37000400","Total",5692,2812,2880,5655,37,51,221.00,25.8
"2011","Rhosllanerchrugog BUA","W37000401","Total",25362,12538,12824,25161,201,197,770.25,32.9
"2011","Ebbw Vale BUA","W37000402","Total",33068,16223,16845,32726,342,264,950.00,34.8
"2011","Saundersfoot BUA","W37000403","Total",3361,1651,1710,3215,146,54,156.75,21.4
"2011","Rhigos BUA","W37000404","Total",718,354,364,717,1,5,77.25,9.3
"2011","Cwmfelinfach/Ynysddu BUA","W37000405","Total",2342,1114,1228,2307,35,16,58.50,40.0
"2011","Welshpool BUA","W37000406","Total",5948,2907,3041,5751,197,74,241.50,24.6
"2011","Rhyl/Prestatyn BUA","W37000407","Total",46267,22505,23762,46098,169,434,1290.00,35.9
"2011","Colwyn Bay BUA","W37000408","Total",34284,16536,17748,33249,1035,540,1016.75,33.7
"2011","Llanelli BUA","W37000409","Total",49591,24136,25455,49020,571,460,1508.00,32.9
"2011","Undy BUA","W37000410","Total",5914,2948,2966,5905,9,102,186.50,31.7
"2011","Flint BUA","W37000411","Total",26442,13039,13403,26232,210,244,849.50,31.1
"2011","Ogmore Vale/Nant-y-moel BUA","W37000412","Total",5461,2652,2809,5461,0,27,123.25,44.3
"2011","Bethesda BUA","W37000413","Total",4735,2330,2405,4712,23,56,134.50,35.2
"2011","Llantrisant BUA","W37000414","Total",14422,7006,7416,14336,86,174,460.50,31.3
"2011","Rhymney BUA","W37000415","Total",8537,4168,4369,8471,66,63,232.75,36.7
"2011","Gwernaffield-y-Waun/Pantymwyn BUA","W37000416","Total",1734,849,885,1734,0,31,91.75,18.9
"2011","Abergavenny BUA","W37000417","Total",14651,7005,7646,14480,171,205,457.50,32.0
"2011","Marshfield (Newport) BUA","W37000418","Total",3054,1475,1579,3015,39,51,100.25,30.5
"2011","Bangor BUA","W37000419","Total",17988,8845,9143,15288,2700,272,428.00,42.0
"2011","Bryn Pydew BUA","W37000420","Total",11109,5383,5726,10860,249,147,386.25,28.8
"2011","Mynydd-bach/Shirenewton BUA","W37000421","Total",657,329,328,657,0,20,43.25,15.2
"2011","Tonypandy BUA","W37000422","Total",62545,30608,31937,61939,606,405,1275.00,49.1
"2011","St Clears BUA","W37000423","Total",2663,1279,1384,2574,89,51,111.25,23.9
"2011","Church Village BUA","W37000424","Total",23277,11364,11913,23200,77,224,537.00,43.3
"2011","Glyn-neath BUA","W37000425","Total",5419,2672,2747,5384,35,42,169.00,32.1
"2011","Fairbourne BUA","W37000426","Total",721,357,364,717,4,8,53.75,13.4
"2011","Swansea BUA","W37000427","Total",300352,147989,152363,295153,5199,2899,8755.24,34.3